Sum of Female(Individuals Vaccinated),Sum of First Dose Administered,Sum of Male(Individuals Vaccinated),Sum of Second Dose Administered,State,Sum of Total Covaxin Administered,Sum of Total CoviShield Administered,Sum of Total Doses Administered,Sum of Total Individuals Registered,Sum of Total Individuals Vaccinated,Sum of Total Sessions Conducted,Sum of Total Sites ,Sum of Transgender(Individuals Vaccinated),Updated On
6468,16017,9549,5194,Andaman and Nicobar Islands,1,16016,21211,22507,16017,881,32,0,01/04/2021
3008,6638,3630,2086,Andaman and Nicobar Islands,0,6638,8724,15334,6638,161,15,0,02/03/2021
6513,16104,9591,5198,Andaman and Nicobar Islands,1,16103,21302,22581,16104,895,32,0,02/04/2021
1506,2107,601,0,Andaman and Nicobar Islands,0,2107,2107,13820,2107,56,12,0,03/02/2021
3028,6749,3721,2088,Andaman and Nicobar Islands,0,6749,8837,15353,6749,172,16,0,03/03/2021
6691,16470,9779,5242,Andaman and Nicobar Islands,1,16469,21712,23037,16470,932,32,0,03/04/2021
1631,2290,659,0,Andaman and Nicobar Islands,0,2290,2290,13990,2290,57,13,0,04/02/2021
3133,7266,4133,2095,Andaman and Nicobar Islands,0,7266,9361,15508,7266,182,16,0,04/03/2021
7681,18677,10996,5224,Andaman and Nicobar Islands,0,23901,23901,18677,18677,1200,12,0,04/04/2021
1809,2514,705,0,Andaman and Nicobar Islands,0,2514,2514,14151,2514,63,13,0,05/02/2021
3240,7799,4559,2098,Andaman and Nicobar Islands,0,7799,9897,15640,7799,198,16,0,05/03/2021
8062,19499,11437,5275,Andaman and Nicobar Islands,0,24774,24774,19499,19499,1800,18,0,05/04/2021
2035,2780,745,0,Andaman and Nicobar Islands,0,2780,2780,14367,2780,65,13,0,06/02/2021
3373,8288,4915,2210,Andaman and Nicobar Islands,0,8288,10498,15869,8288,224,16,0,06/03/2021
8548,20445,11897,5321,Andaman and Nicobar Islands,0,25766,25766,20445,20445,2300,23,0,06/04/2021
3597,8848,5251,2253,Andaman and Nicobar Islands,0,8848,11101,16666,8848,227,16,0,07/03/2021
9645,22631,12986,5347,Andaman and Nicobar Islands,0,27978,27978,22631,22631,2400,23,0,07/04/2021
3757,9629,5872,2375,Andaman and Nicobar Islands,0,9629,12004,16968,9629,261,16,0,08/03/2021
10957,25363,14405,5403,Andaman and Nicobar Islands,0,30766,30766,25363,25363,2800,28,1,08/04/2021
3855,9916,6061,2391,Andaman and Nicobar Islands,0,9916,12307,17172,9916,264,16,0,09/03/2021
12115,27698,15582,5519,Andaman and Nicobar Islands,0,33217,33217,27698,27698,2800,28,1,09/04/2021
3938,10139,6201,2427,Andaman and Nicobar Islands,0,10139,12566,17363,10139,270,16,0,10/03/2021
13172,29863,16690,5570,Andaman and Nicobar Islands,0,35433,35433,29863,29863,3000,29,1,10/04/2021
4085,10652,6567,2486,Andaman and Nicobar Islands,0,10652,13138,17687,10652,288,16,0,11/03/2021
14145,32012,17866,5612,Andaman and Nicobar Islands,0,37624,37624,32012,32012,2800,28,1,11/04/2021
2079,2852,773,0,Andaman and Nicobar Islands,0,2852,2852,14549,2852,74,14,0,12/02/2021
4262,11200,6938,2586,Andaman and Nicobar Islands,0,11200,13786,17995,11200,295,16,0,12/03/2021
16392,36572,20175,5713,Andaman and Nicobar Islands,0,42285,42285,36572,36572,3400,33,5,12/04/2021
2102,3040,938,0,Andaman and Nicobar Islands,0,3040,3040,14618,3040,74,14,0,13/02/2021
4342,11393,7051,2740,Andaman and Nicobar Islands,0,11393,14133,18172,11393,298,16,0,13/03/2021
19575,43013,23433,5832,Andaman and Nicobar Islands,0,48845,48845,43013,43013,3400,32,5,13/04/2021
4368,11449,7081,2768,Andaman and Nicobar Islands,0,11449,14217,18226,11449,308,16,0,14/03/2021
22690,49654,26959,5941,Andaman and Nicobar Islands,0,55595,55595,49654,49654,3300,32,5,14/04/2021
2187,3363,1176,104,Andaman and Nicobar Islands,0,3363,3467,14685,3363,78,14,0,15/02/2021
4510,11744,7234,2844,Andaman and Nicobar Islands,0,11744,14588,18510,11744,313,16,0,15/03/2021
25088,54778,29685,6079,Andaman and Nicobar Islands,0,60857,60857,54778,54778,4000,35,5,15/04/2021
11,23,12,0,Andaman and Nicobar Islands,0,23,23,6028,23,2,2,0,16/01/2021
2187,3363,1176,104,Andaman and Nicobar Islands,0,3363,3467,14704,3363,81,14,0,16/02/2021
4636,12051,7415,2878,Andaman and Nicobar Islands,1,12050,14929,18807,12051,338,16,0,16/03/2021
28138,61339,33196,6323,Andaman and Nicobar Islands,0,67662,67662,61339,61339,4900,36,5,16/04/2021
2217,3560,1343,104,Andaman and Nicobar Islands,0,3560,3664,14941,3560,86,14,0,17/02/2021
4670,12142,7472,2983,Andaman and Nicobar Islands,1,12141,15125,18891,12142,340,16,0,17/03/2021
31010,67451,36435,6568,Andaman and Nicobar Islands,0,74019,74019,67451,67451,4300,40,6,17/04/2021
13,42,29,0,Andaman and Nicobar Islands,0,42,42,5719,42,9,2,0,18/01/2021
2050,3505,1455,341,Andaman and Nicobar Islands,0,3505,3846,14619,3505,95,14,0,18/02/2021
4820,12482,7662,3192,Andaman and Nicobar Islands,1,12481,15674,19202,12482,357,17,0,18/03/2021
32769,71275,38500,6878,Andaman and Nicobar Islands,0,78153,78153,71275,71275,4700,47,6,18/04/2021
36,89,53,0,Andaman and Nicobar Islands,0,89,89,6731,89,12,2,0,19/01/2021
2441,4246,1805,652,Andaman and Nicobar Islands,0,4246,4898,15059,4246,101,14,0,19/02/2021
4967,12801,7834,3331,Andaman and Nicobar Islands,1,12800,16132,19517,12801,434,22,0,19/03/2021
34776,75675,40893,7353,Andaman and Nicobar Islands,0,83028,83028,75675,75675,4750,46,6,19/04/2021
57,124,67,0,Andaman and Nicobar Islands,0,124,124,6870,124,16,3,0,20/01/2021
5183,13249,8066,3611,Andaman and Nicobar Islands,1,13248,16860,19918,13249,535,28,0,20/03/2021
36248,78973,42718,7937,Andaman and Nicobar Islands,0,86910,86910,78973,78973,4800,47,7,20/04/2021
129,239,110,0,Andaman and Nicobar Islands,0,239,239,8550,239,22,6,0,21/01/2021
5189,13262,8073,3622,Andaman and Nicobar Islands,1,13261,16884,19930,13262,629,30,0,21/03/2021
37076,80901,43818,8171,Andaman and Nicobar Islands,0,89072,89072,80901,80901,4100,40,7,21/04/2021
321,552,231,0,Andaman and Nicobar Islands,0,552,552,9697,552,29,6,0,22/01/2021
5358,13633,8275,3773,Andaman and Nicobar Islands,1,13632,17406,20280,13633,669,31,0,22/03/2021
38081,83233,45145,8600,Andaman and Nicobar Islands,0,91833,91833,83233,83233,4200,42,7,22/04/2021
578,920,342,0,Andaman and Nicobar Islands,0,920,920,10694,920,32,9,0,23/01/2021
5642,14213,8571,4117,Andaman and Nicobar Islands,1,14212,18330,20813,14213,684,31,0,23/03/2021
38978,85201,46215,8965,Andaman and Nicobar Islands,0,94166,94166,85201,85201,4200,42,8,23/04/2021
609,966,357,0,Andaman and Nicobar Islands,0,966,966,12398,966,38,9,0,24/01/2021
5728,14377,8649,4460,Andaman and Nicobar Islands,1,14376,18837,20966,14377,691,32,0,24/03/2021
39679,86796,47109,9297,Andaman and Nicobar Islands,0,96093,96093,86796,86796,3900,37,8,24/04/2021
1072,1519,447,0,Andaman and Nicobar Islands,0,1519,1519,13051,1519,43,10,0,25/01/2021
5884,14677,8793,4680,Andaman and Nicobar Islands,1,14676,19357,21264,14677,696,32,0,25/03/2021
40146,87865,47711,9527,Andaman and Nicobar Islands,0,97392,97392,87865,87865,3500,35,8,25/04/2021
5981,14905,8924,4871,Andaman and Nicobar Islands,1,14904,19776,21468,14905,713,32,0,26/03/2021
40786,89290,48496,9819,Andaman and Nicobar Islands,0,99109,99109,89290,89290,3500,34,8,26/04/2021
6121,15205,9084,5080,Andaman and Nicobar Islands,1,15204,20285,21759,15205,716,32,0,27/03/2021
41330,90454,49116,10117,Andaman and Nicobar Islands,0,100571,100571,90454,90454,3500,34,8,27/04/2021
1393,1956,563,0,Andaman and Nicobar Islands,0,1956,1956,13454,1956,48,10,0,28/01/2021
1436,2024,588,0,Andaman and Nicobar Islands,0,2024,2024,13564,2024,50,10,0,29/01/2021
1469,2060,591,0,Andaman and Nicobar Islands,0,2060,2060,13609,2060,51,10,0,30/01/2021
6251,15503,9252,5155,Andaman and Nicobar Islands,1,15502,20658,22043,15503,748,32,0,30/03/2021
6275,15547,9272,5157,Andaman and Nicobar Islands,1,15546,20704,22106,15547,854,32,0,31/03/2021
92862,133642,40763,0,Andhra Pradesh,7925,125717,133642,474340,133642,10327,1843,17,01/02/2021
1112003,2297625,1185411,403751,Andhra Pradesh,404484,1893141,2701376,2742748,2297625,182605,6511,211,01/04/2021
92864,133646,40765,0,Andhra Pradesh,7925,125721,133646,474845,133646,11480,2392,17,02/02/2021
286947,559569,272575,142466,Andhra Pradesh,67418,492151,702035,1007956,559569,44866,3900,47,02/03/2021
1140150,2354778,1214408,408955,Andhra Pradesh,424101,1930677,2763733,2793548,2354778,183768,6642,220,02/04/2021
105152,161302,56129,0,Andhra Pradesh,10893,150409,161302,507183,161302,12258,2490,21,03/02/2021
293510,577662,284104,146457,Andhra Pradesh,69578,508084,724119,1022498,577662,51667,3942,48,03/03/2021
1178736,2430834,1251872,416786,Andhra Pradesh,445869,1984965,2847620,2880422,2430834,184802,6732,226,03/04/2021
116449,188704,72231,0,Andhra Pradesh,13959,174745,188704,532501,188704,13539,2591,24,04/02/2021
300746,596324,295529,153121,Andhra Pradesh,71701,524623,749445,1038438,596324,69948,4470,49,04/03/2021
1269318,2621707,1352129,425861,Andhra Pradesh,546389,2501179,3047568,2621707,2621707,139081,922,260,04/04/2021
128708,218899,90167,0,Andhra Pradesh,17464,201435,218899,569020,218899,14549,2673,24,05/02/2021
310748,620332,309536,164927,Andhra Pradesh,74476,545856,785259,1060519,620332,82741,4633,48,05/03/2021
1313862,2706804,1392670,436010,Andhra Pradesh,567792,2575022,3142814,2706804,2706804,407860,2470,272,05/04/2021
139953,245938,105960,0,Andhra Pradesh,20484,225454,245938,597303,245938,15374,2722,25,06/02/2021
324908,653058,328100,183119,Andhra Pradesh,78593,574465,836177,1090348,653058,90238,4767,50,06/03/2021
1344250,2764322,1419795,443595,Andhra Pradesh,584072,2623845,3207917,2764322,2764322,372084,2274,277,06/04/2021
141043,249205,108137,0,Andhra Pradesh,20627,228578,249205,599444,249205,15966,2772,25,07/02/2021
324983,653146,328113,183191,Andhra Pradesh,78617,574529,836337,1090442,653146,92172,4800,50,07/03/2021
1410248,2890332,1479792,461678,Andhra Pradesh,619956,2732054,3352010,2890332,2890332,416382,2308,292,07/04/2021
146839,263588,116724,0,Andhra Pradesh,23315,240273,263588,626793,263588,16965,2800,25,08/02/2021
340859,688936,348024,197239,Andhra Pradesh,82883,606053,886175,1124828,688936,103973,5022,53,08/03/2021
1478742,3020007,1540961,476360,Andhra Pradesh,652047,2844320,3496367,3020007,3020007,425051,2309,304,08/04/2021
151194,275654,124433,0,Andhra Pradesh,26245,249409,275654,652813,275654,17614,2826,27,09/02/2021
357165,725040,367817,210304,Andhra Pradesh,87054,637986,935344,1159541,725040,111852,5064,58,09/03/2021
1508662,3081066,1572089,490040,Andhra Pradesh,665935,2905171,3571106,3081066,3081066,315795,2000,315,09/04/2021
155314,286401,131060,0,Andhra Pradesh,29230,257171,286401,680525,286401,18589,2865,27,10/02/2021
372943,760122,387116,219281,Andhra Pradesh,91219,668903,979403,1193233,760122,140665,5072,63,10/03/2021
1610286,3281351,1670720,521886,Andhra Pradesh,688816,3114421,3803237,3281351,3281351,415755,2308,345,10/04/2021
158721,294574,135823,0,Andhra Pradesh,31656,262918,294574,709960,294574,19437,2914,30,11/02/2021
376065,767441,391313,220756,Andhra Pradesh,92697,674744,988197,1200486,767441,146172,5074,63,11/03/2021
1652442,3362926,1710124,529533,Andhra Pradesh,716938,3175521,3892459,3362926,3362926,374351,1465,360,11/04/2021
162400,303031,140600,0,Andhra Pradesh,33536,269495,303031,751986,303031,20646,2934,31,12/02/2021
395468,809337,413804,231454,Andhra Pradesh,98371,710966,1040791,1241737,809337,151935,5079,65,12/03/2021
1660680,3380423,1719378,533246,Andhra Pradesh,728993,3184676,3913669,3380423,3380423,314600,1984,365,12/04/2021
169422,313507,144054,6233,Andhra Pradesh,34633,278874,319740,794518,313507,22222,2959,31,13/02/2021
413896,848663,434697,237312,Andhra Pradesh,103816,744847,1085975,1280582,848663,154927,5081,70,13/03/2021
1662197,3383754,1721192,534765,Andhra Pradesh,729750,3188769,3918519,3383754,3383754,182750,1357,365,13/04/2021
169423,313509,144055,6234,Andhra Pradesh,34634,278875,319743,798170,313509,22755,2965,31,14/02/2021
414258,849416,435088,237369,Andhra Pradesh,103935,745481,1086785,1280618,849416,155413,5081,70,14/03/2021
1971969,3973533,2001124,585223,Andhra Pradesh,925165,3633591,4558756,3973533,3973533,1150180,3403,440,14/04/2021
180470,329041,148538,16789,Andhra Pradesh,35388,293653,345830,852081,329041,23889,2995,33,15/02/2021
446096,917600,471419,246970,Andhra Pradesh,114467,803133,1164570,1348652,917600,159489,5086,85,15/03/2021
1986583,4003901,2016874,593541,Andhra Pradesh,939760,3657682,4597442,4003901,4003901,260050,1633,444,15/04/2021
3359,4216,857,0,Andhra Pradesh,0,4216,4216,277023,4216,541,339,0,16/01/2021
191072,344146,153041,26734,Andhra Pradesh,36414,307732,370880,913690,344146,25140,3012,33,16/02/2021
475468,978626,503066,258055,Andhra Pradesh,123828,854798,1236681,1409126,978626,162515,5089,92,16/03/2021
7374,9251,1876,0,Andhra Pradesh,0,9251,9251,277071,9251,1025,444,1,17/01/2021
204789,364844,160016,38007,Andhra Pradesh,37477,327367,402851,965504,364844,26455,3046,39,17/02/2021
506340,1043371,536937,268383,Andhra Pradesh,135237,908134,1311754,1473561,1043371,163323,5092,94,17/03/2021
1989380,4009940,2020113,597920,Andhra Pradesh,944014,3663846,4607860,4009940,4009940,83450,597,447,17/04/2021
9260,12234,2974,0,Andhra Pradesh,0,12234,12234,272214,12234,1458,581,0,18/01/2021
198938,359785,160812,54253,Andhra Pradesh,38015,321770,414038,917214,359785,27439,3102,35,18/02/2021
542222,1120551,578224,277977,Andhra Pradesh,149483,971068,1398528,1551088,1120551,164833,5099,105,18/03/2021
1990964,4013140,2021729,599876,Andhra Pradesh,944220,3668796,4613016,4013140,4013140,58100,396,447,18/04/2021
15975,25539,9564,0,Andhra Pradesh,0,25539,25539,280631,25539,2039,828,0,19/01/2021
229118,403279,174122,73226,Andhra Pradesh,39850,363429,476505,1013388,403279,28331,3134,39,19/02/2021
580286,1200656,620257,288195,Andhra Pradesh,162933,1037723,1488851,1632914,1200656,165781,5102,113,19/03/2021
2048468,4140526,2091593,616056,Andhra Pradesh,947164,3809418,4756582,4140526,4140526,297050,1912,465,19/04/2021
24961,35901,10940,0,Andhra Pradesh,135,35766,35901,288452,35901,3111,1125,0,20/01/2021
234535,413818,179244,87470,Andhra Pradesh,41060,372758,501288,1018653,413818,29308,3152,39,20/02/2021
625198,1294501,669181,299229,Andhra Pradesh,180336,1114165,1593730,1726345,1294501,166458,5103,122,20/03/2021
2090498,4234572,2143599,692783,Andhra Pradesh,966614,3960741,4927355,4234572,4234572,274150,2035,475,20/04/2021
32228,45040,12812,0,Andhra Pradesh,395,44645,45040,298734,45040,4286,1342,0,21/01/2021
237293,418634,181302,90410,Andhra Pradesh,41740,376894,509044,1019634,418634,29994,3171,39,21/02/2021
628463,1301331,672744,300650,Andhra Pradesh,182933,1118398,1601981,1729765,1301331,167130,5111,124,21/03/2021
2100050,4257182,2156651,711267,Andhra Pradesh,974969,3993480,4968449,4257182,4257182,275132,2041,481,21/04/2021
39779,55697,15918,0,Andhra Pradesh,573,55124,55697,311109,55697,5151,1412,0,22/01/2021
243679,431789,188071,102718,Andhra Pradesh,43806,387983,534507,1024950,431789,31021,3232,39,22/02/2021
676845,1401953,724978,309106,Andhra Pradesh,199459,1202494,1711059,1839092,1401953,168441,5112,130,22/03/2021
2137627,4337021,2198899,990865,Andhra Pradesh,1012178,4315708,5327886,4337021,4337021,304361,2248,495,22/04/2021
50203,70380,20177,0,Andhra Pradesh,947,69433,70380,320527,70380,6375,1528,0,23/01/2021
251481,448490,196967,110993,Andhra Pradesh,47078,401412,559483,1025283,448490,32298,3362,42,23/02/2021
734009,1520072,785921,321417,Andhra Pradesh,221244,1298828,1841489,1950664,1520072,169174,5139,142,23/03/2021
2196954,4464620,2267153,1090159,Andhra Pradesh,1028859,4525920,5554779,4464620,4464620,286490,2187,513,23/04/2021
53272,74221,20948,0,Andhra Pradesh,1087,73134,74221,327120,74221,6922,1593,1,24/01/2021
259404,476866,217419,119461,Andhra Pradesh,53659,423207,596327,1026640,476866,33332,3398,43,24/02/2021
785181,1627231,841903,332643,Andhra Pradesh,242684,1384547,1959874,2058577,1627231,169889,5314,147,24/03/2021
2232281,4543318,2310508,1126549,Andhra Pradesh,1035362,4634505,5669867,4543318,4543318,231700,1953,529,24/04/2021
64381,89879,25497,0,Andhra Pradesh,1984,87895,89879,358894,89879,7342,1629,1,25/01/2021
270049,510185,240092,129002,Andhra Pradesh,60574,449611,639187,1026881,510185,34220,3409,44,25/02/2021
848040,1757017,908822,347161,Andhra Pradesh,267035,1489982,2104178,2189156,1757017,171282,5344,155,25/03/2021
2234361,4547972,2313082,1130670,Andhra Pradesh,1035700,4642942,5678642,4547972,4547972,84100,560,529,25/04/2021
64926,90616,25689,0,Andhra Pradesh,1995,88621,90616,375359,90616,7575,1658,1,26/01/2021
278935,535955,256973,137812,Andhra Pradesh,65196,470759,673767,991006,535955,34950,3414,47,26/02/2021
891240,1849681,958272,359882,Andhra Pradesh,286172,1563509,2209563,2283058,1849681,172357,5394,169,26/03/2021
2333503,4761686,2427613,1224397,Andhra Pradesh,1038678,4947405,5986083,4761686,4761686,261120,2046,570,26/04/2021
76840,107999,31152,0,Andhra Pradesh,3166,104833,107999,410863,107999,7913,1713,7,27/01/2021
946309,1962435,1015945,372957,Andhra Pradesh,309635,1652800,2335392,2395650,1962435,173296,5410,181,27/03/2021
2398847,4904030,2504587,1273663,Andhra Pradesh,1041050,5136643,6177693,4904030,4904030,261120,2068,596,27/04/2021
82580,117543,34950,0,Andhra Pradesh,4631,112912,117543,428934,117543,8486,1745,13,28/01/2021
278935,535955,256973,137812,Andhra Pradesh,65196,470759,673767,991007,535955,35027,3432,47,28/02/2021
950419,1970567,1019967,374542,Andhra Pradesh,311011,1659556,2345109,2403594,1970567,174209,5459,181,28/03/2021
87110,124647,37524,0,Andhra Pradesh,5812,118835,124647,446725,124647,8914,1779,13,29/01/2021
979606,2029994,1050201,377654,Andhra Pradesh,327255,1702739,2407648,2464049,2029994,174861,5492,187,29/03/2021
92814,133571,40740,0,Andhra Pradesh,7925,125646,133571,461589,133571,9514,1808,17,30/01/2021
1018514,2111636,1092925,387219,Andhra Pradesh,346721,1764915,2498855,2545810,2111636,176992,5896,197,30/03/2021
92849,133623,40757,0,Andhra Pradesh,7925,125698,133623,471321,133623,9940,1818,17,31/01/2021
1063924,2202436,1138306,396260,Andhra Pradesh,372148,1830288,2598696,2638157,2202436,180520,6289,206,31/03/2021
5098,6668,1570,0,Arunachal Pradesh,0,6668,6668,48271,6668,330,154,0,01/02/2021
12163,25903,13740,6962,Arunachal Pradesh,76,25827,32865,61953,25903,1431,208,0,01/03/2021
29527,74514,44923,22604,Arunachal Pradesh,178,74336,97118,103206,74514,4376,240,64,01/04/2021
5098,6668,1570,0,Arunachal Pradesh,0,6668,6668,48299,6668,359,165,0,02/02/2021
12569,29841,17272,7649,Arunachal Pradesh,80,29761,37490,63853,29841,1511,208,0,02/03/2021
30348,76246,45834,23055,Arunachal Pradesh,178,76068,99301,104947,76246,4446,240,64,02/04/2021
5161,6758,1597,0,Arunachal Pradesh,0,6758,6758,48443,6758,388,174,0,03/02/2021
12658,30253,17595,7684,Arunachal Pradesh,86,30167,37937,64086,30253,1667,209,0,03/03/2021
31777,79454,47613,24009,Arunachal Pradesh,178,79276,103463,108376,79454,4578,240,64,03/04/2021
5953,7785,1832,0,Arunachal Pradesh,0,7785,7785,49683,7785,423,178,0,04/02/2021
13345,33136,19791,8262,Arunachal Pradesh,111,33025,41398,65986,33136,1747,210,0,04/03/2021
32902,79783,46817,22825,Arunachal Pradesh,0,102608,102608,79783,79783,8050,53,64,04/04/2021
6597,8745,2148,0,Arunachal Pradesh,0,8745,8745,50649,8745,455,183,0,05/02/2021
14001,35734,21733,9147,Arunachal Pradesh,116,35618,44881,67876,35734,1871,212,0,05/03/2021
34315,82757,48378,23931,Arunachal Pradesh,0,106688,106688,82757,82757,12600,100,64,05/04/2021
7017,9288,2271,0,Arunachal Pradesh,0,9288,9288,51323,9288,466,183,0,06/02/2021
14530,37249,22719,9652,Arunachal Pradesh,125,37124,46901,68997,37249,1924,212,0,06/03/2021
35157,84581,49360,24583,Arunachal Pradesh,0,109164,109164,84581,84581,9200,76,64,06/04/2021
7020,9292,2272,0,Arunachal Pradesh,0,9292,9292,51384,9292,498,190,0,07/02/2021
14548,37299,22751,9661,Arunachal Pradesh,128,37171,46960,69061,37299,2081,213,0,07/03/2021
36714,88000,51221,25682,Arunachal Pradesh,0,113682,113682,88000,88000,10500,80,65,07/04/2021
7598,10438,2840,0,Arunachal Pradesh,6,10432,10438,52568,10438,510,192,0,08/02/2021
15327,39451,24124,10499,Arunachal Pradesh,141,39310,49950,70986,39451,2170,213,0,08/03/2021
39212,93106,53829,27291,Arunachal Pradesh,0,120397,120397,93106,93106,14150,113,65,08/04/2021
7601,10465,2864,0,Arunachal Pradesh,28,10437,10465,52914,10465,542,193,0,09/02/2021
15845,41027,25182,10860,Arunachal Pradesh,142,40885,51887,72202,41027,2214,213,0,09/03/2021
41500,97939,56374,28524,Arunachal Pradesh,0,126463,126463,97939,97939,13350,112,65,09/04/2021
7641,10529,2888,0,Arunachal Pradesh,28,10501,10529,53454,10529,575,196,0,10/02/2021
15898,41216,25318,10906,Arunachal Pradesh,147,41069,52122,72325,41216,2352,214,0,10/03/2021
43136,101756,58554,29546,Arunachal Pradesh,0,131302,131302,101756,101756,11700,91,66,10/04/2021
8020,11372,3352,0,Arunachal Pradesh,28,11344,11372,55048,11372,610,196,0,11/02/2021
16704,43375,26671,11548,Arunachal Pradesh,156,43219,54923,74142,43375,2476,214,0,11/03/2021
44556,104975,60353,30001,Arunachal Pradesh,0,134976,134976,104975,104975,12450,96,66,11/04/2021
8320,12173,3853,0,Arunachal Pradesh,28,12145,12173,56445,12173,652,196,0,12/02/2021
17358,45126,27768,12098,Arunachal Pradesh,156,44970,57224,75634,45126,2557,215,0,12/03/2021
48102,112551,64383,31586,Arunachal Pradesh,0,144137,144137,112551,112551,18900,145,66,12/04/2021
8719,13251,4532,456,Arunachal Pradesh,28,13223,13707,57373,13251,676,198,0,13/02/2021
17730,46109,28379,12556,Arunachal Pradesh,158,45951,58665,76475,46109,2597,215,0,13/03/2021
50907,118825,67852,33023,Arunachal Pradesh,0,151848,151848,118825,118825,17370,116,66,13/04/2021
8720,13274,4554,456,Arunachal Pradesh,28,13246,13730,57536,13274,720,198,0,14/02/2021
17740,46169,28429,12569,Arunachal Pradesh,158,46011,58738,76532,46169,2784,217,0,14/03/2021
53610,124312,70635,33700,Arunachal Pradesh,0,158012,158012,124312,124312,15350,120,67,14/04/2021
9713,15434,5721,1584,Arunachal Pradesh,28,15406,17018,59188,15434,742,199,0,15/02/2021
18743,48807,30064,13348,Arunachal Pradesh,164,48643,62155,78767,48807,2935,220,0,15/03/2021
54872,126950,72011,34210,Arunachal Pradesh,0,161160,161160,126950,126950,12050,93,67,15/04/2021
41,81,40,0,Arunachal Pradesh,0,81,81,13096,81,10,9,0,16/01/2021
9733,15546,5813,1584,Arunachal Pradesh,30,15516,17130,59576,15546,788,199,0,16/02/2021
19316,50316,31000,13923,Arunachal Pradesh,166,50150,64239,80072,50316,2981,220,0,16/03/2021
56691,130812,74054,35820,Arunachal Pradesh,0,166632,166632,130812,130812,13500,115,67,16/04/2021
108,178,70,0,Arunachal Pradesh,0,178,178,15695,178,44,30,0,17/01/2021
9733,15552,5819,1584,Arunachal Pradesh,30,15522,17136,59924,15552,857,199,0,17/02/2021
19325,50393,31068,14009,Arunachal Pradesh,166,50227,64402,80122,50393,3105,225,0,17/03/2021
58152,133947,75726,36809,Arunachal Pradesh,0,170756,170756,133947,133947,12300,96,69,17/04/2021
441,560,119,0,Arunachal Pradesh,0,560,560,28987,560,74,50,0,18/01/2021
10203,17389,7186,3032,Arunachal Pradesh,34,17355,20421,59004,17389,930,201,0,18/02/2021
20234,52937,32703,15041,Arunachal Pradesh,167,52770,67978,82368,52937,3217,225,0,18/03/2021
58820,135342,76453,37272,Arunachal Pradesh,0,172614,172614,135342,135342,8250,69,69,18/04/2021
452,574,122,0,Arunachal Pradesh,0,574,574,29353,574,77,51,0,19/01/2021
11337,19872,8535,4110,Arunachal Pradesh,35,19837,23982,62295,19872,951,202,0,19/02/2021
20941,54683,33741,15929,Arunachal Pradesh,168,54515,70612,84011,54683,3319,227,1,19/03/2021
61233,140794,79492,39493,Arunachal Pradesh,0,180287,180287,140794,140794,12950,105,69,19/04/2021
468,601,133,0,Arunachal Pradesh,0,601,601,33972,601,127,76,0,20/01/2021
11363,20018,8655,4220,Arunachal Pradesh,54,19964,24238,62360,20018,993,202,0,20/02/2021
21583,56486,34902,16500,Arunachal Pradesh,169,56317,72986,85729,56486,3367,227,1,20/03/2021
63291,145098,81737,40904,Arunachal Pradesh,0,186002,186002,145098,145098,10750,82,70,20/04/2021
852,1154,302,0,Arunachal Pradesh,0,1154,1154,39366,1154,175,104,0,21/01/2021
11363,20018,8655,4220,Arunachal Pradesh,54,19964,24238,62361,20018,1044,202,0,21/02/2021
21667,56658,34990,16520,Arunachal Pradesh,172,56486,73178,85837,56658,3536,229,1,21/03/2021
64874,148680,83736,41786,Arunachal Pradesh,0,190466,190466,148680,148680,13050,105,70,21/04/2021
1390,1818,428,0,Arunachal Pradesh,0,1818,1818,42290,1818,200,115,0,22/01/2021
11588,21550,9962,5354,Arunachal Pradesh,71,21479,26904,62362,21550,1091,202,0,22/02/2021
22663,59149,36485,17415,Arunachal Pradesh,173,58976,76564,88228,59149,3629,230,1,22/03/2021
67261,153966,86634,43477,Arunachal Pradesh,0,197443,197443,153966,153966,15600,120,71,22/04/2021
1860,2446,586,0,Arunachal Pradesh,0,2446,2446,43106,2446,208,120,0,23/01/2021
11757,22757,11000,5687,Arunachal Pradesh,73,22684,28444,62456,22757,1130,204,0,23/02/2021
23464,60948,37482,18215,Arunachal Pradesh,175,60773,79163,89956,60948,3689,230,2,23/03/2021
69519,159167,89577,45334,Arunachal Pradesh,0,204501,204501,159167,159167,14300,115,71,23/04/2021
1920,2529,609,0,Arunachal Pradesh,0,2529,2529,43651,2529,227,124,0,24/01/2021
11761,22781,11020,5687,Arunachal Pradesh,73,22708,28468,62526,22781,1212,207,0,24/02/2021
23528,61085,37555,18315,Arunachal Pradesh,175,60910,79400,89981,61085,3783,233,2,24/03/2021
71033,162665,91561,46515,Arunachal Pradesh,0,209180,209180,162665,162665,11900,89,71,24/04/2021
2605,3442,837,0,Arunachal Pradesh,0,3442,3442,44546,3442,235,130,0,25/01/2021
12036,24649,12613,6560,Arunachal Pradesh,73,24576,31209,62538,24649,1265,207,0,25/02/2021
24651,63751,39043,19115,Arunachal Pradesh,177,63574,82866,92570,63751,3900,234,57,25/03/2021
71392,163535,92072,46800,Arunachal Pradesh,0,210335,210335,163535,163535,6100,43,71,25/04/2021
2614,3462,848,0,Arunachal Pradesh,0,3462,3462,44785,3462,240,133,0,26/01/2021
12163,25903,13740,6962,Arunachal Pradesh,76,25827,32865,60797,25903,1281,207,0,26/02/2021
25515,65840,40261,19797,Arunachal Pradesh,177,65663,85637,94520,65840,3992,234,64,26/03/2021
73540,168174,94562,48543,Arunachal Pradesh,0,216717,216717,168174,168174,12700,99,72,26/04/2021
2981,3998,1017,0,Arunachal Pradesh,0,3998,3998,45042,3998,269,144,0,27/01/2021
12163,25903,13740,6962,Arunachal Pradesh,76,25827,32865,60985,25903,1281,207,0,27/02/2021
26499,67852,41289,19969,Arunachal Pradesh,177,67675,87821,96494,67852,4061,234,64,27/03/2021
75313,172178,96792,49907,Arunachal Pradesh,0,222085,222085,172178,172178,12200,89,73,27/04/2021
4107,5470,1363,0,Arunachal Pradesh,0,5470,5470,45956,5470,294,150,0,28/01/2021
12163,25903,13740,6962,Arunachal Pradesh,76,25827,32865,61946,25903,1349,210,0,28/02/2021
26522,67913,41327,20021,Arunachal Pradesh,177,67736,87934,96555,67913,4096,234,64,28/03/2021
4615,6106,1491,0,Arunachal Pradesh,0,6106,6106,47022,6106,301,150,0,29/01/2021
26691,68337,41582,20038,Arunachal Pradesh,177,68160,88375,96978,68337,4169,234,64,29/03/2021
4948,6491,1543,0,Arunachal Pradesh,0,6491,6491,47837,6491,304,150,0,30/01/2021
27267,69680,42349,20989,Arunachal Pradesh,177,69503,90669,98278,69680,4221,234,64,30/03/2021
4969,6525,1556,0,Arunachal Pradesh,0,6525,6525,48168,6525,315,151,0,31/01/2021
27367,69890,42459,21085,Arunachal Pradesh,178,69712,90975,98458,69890,4303,239,64,31/03/2021
22324,32329,10004,0,Assam,2392,29937,32329,274884,32329,1240,417,1,01/02/2021
413531,960013,546367,155818,Assam,132065,827948,1115831,1183676,960013,63362,2882,115,01/04/2021
23757,34848,11090,0,Assam,2778,32070,34848,276829,34848,1425,500,1,02/02/2021
117056,216152,99058,30506,Assam,29103,187049,246658,466547,216152,8130,1077,38,02/03/2021
429299,989461,560044,162768,Assam,135537,853924,1152229,1211980,989461,65793,2889,118,02/04/2021
24449,36100,11650,0,Assam,2966,33134,36100,277707,36100,1717,604,1,03/02/2021
120070,236065,115957,32104,Assam,33559,202506,268169,483074,236065,10320,1182,38,03/03/2021
443802,1017354,573433,171057,Assam,138573,878781,1188411,1242833,1017354,68495,2899,119,03/04/2021
36782,52645,15836,0,Assam,4420,48225,52645,285796,52645,1955,656,27,04/02/2021
126004,272629,146586,37901,Assam,40358,232271,310530,513505,272629,12233,1255,39,04/03/2021
456786,1047611,590703,177676,Assam,160819,1064468,1225287,1047611,1047611,134500,876,122,04/04/2021
49735,68628,18866,0,Assam,5631,62997,68628,295388,68628,2136,715,27,05/02/2021
132992,307984,174951,46489,Assam,47477,260507,354473,544162,307984,14442,1319,41,05/03/2021
471325,1075940,604492,186284,Assam,165916,1096308,1262224,1075940,1075940,265440,1797,123,05/04/2021
57786,78498,20683,0,Assam,6707,71791,78498,304472,78498,2249,726,29,06/02/2021
140028,343601,203532,52568,Assam,55858,287743,396169,574723,343601,16828,1332,41,06/03/2021
482540,1097741,615074,192369,Assam,169735,1120375,1290110,1097741,1097741,220500,1524,127,06/04/2021
59173,80284,21082,0,Assam,6845,73439,80284,312455,80284,2401,743,29,07/02/2021
141681,354572,212848,53294,Assam,59290,295282,407866,584685,354572,18440,1376,43,07/03/2021
500643,1133750,632976,204730,Assam,176010,1162470,1338480,1133750,1133750,183231,1279,131,07/04/2021
67617,91026,23380,0,Assam,7630,83396,91026,321178,91026,2637,757,29,08/02/2021
149935,385170,235189,61359,Assam,65609,319561,446529,612525,385170,19819,1380,46,08/03/2021
524011,1181704,657559,223370,Assam,186386,1218688,1405074,1181704,1181704,228070,1746,134,08/04/2021
74947,100295,25317,0,Assam,8370,91925,100295,332040,100295,2779,773,31,09/02/2021
157042,408567,251474,68311,Assam,69966,338601,476878,634418,408567,21374,1392,51,09/03/2021
540564,1215483,674781,238777,Assam,196909,1257351,1454260,1215483,1215483,206150,1564,138,09/04/2021
76865,103044,26148,0,Assam,8399,94645,103044,341141,103044,2917,781,31,10/02/2021
162016,423607,261539,72113,Assam,72528,351079,495720,648281,423607,23239,1400,52,10/03/2021
550345,1236130,685641,249957,Assam,205481,1280606,1486087,1236130,1236130,143090,1195,144,10/04/2021
82434,109906,27441,0,Assam,8731,101175,109906,352407,109906,3068,791,31,11/02/2021
167631,440158,272472,75872,Assam,75401,364757,516030,663383,440158,24701,1410,55,11/03/2021
554148,1244425,690131,254268,Assam,208915,1289778,1498693,1244425,1244425,138010,1069,146,11/04/2021
88900,117506,28575,0,Assam,9012,108494,117506,361959,117506,3189,791,31,12/02/2021
173629,456074,282387,80455,Assam,77946,378128,536529,678501,456074,26177,1418,58,12/03/2021
563184,1263243,699911,267508,Assam,219354,1311397,1530751,1263243,1263243,179270,1372,148,12/04/2021
92182,122050,29837,2006,Assam,9367,112683,124056,365448,122050,3216,792,31,13/02/2021
178762,469858,291036,83867,Assam,80334,389524,553725,691833,469858,26818,1426,60,13/03/2021
568151,1274714,706415,275234,Assam,227004,1322944,1549948,1274714,1274714,151430,1182,148,13/04/2021
92242,122161,29888,2016,Assam,9367,112794,124177,366578,122161,3319,795,31,14/02/2021
179060,470950,291830,83930,Assam,80651,390299,554880,692808,470950,28580,1430,60,14/03/2021
569151,1276940,707641,276936,Assam,228510,1325366,1553876,1276940,1276940,152680,1151,148,14/04/2021
93911,124764,30822,3660,Assam,9542,115222,128424,370221,124764,3497,797,31,15/02/2021
185348,488257,302849,88003,Assam,83728,404529,576260,709209,488257,29893,1444,60,15/03/2021
569517,1277864,708199,277584,Assam,229009,1326439,1555448,1277864,1277864,148987,1087,148,15/04/2021
260,401,141,0,Assam,36,365,401,236847,401,79,64,0,16/01/2021
95861,127777,31885,5169,Assam,9691,118086,132946,378856,127777,3587,797,31,16/02/2021
191087,503905,312758,91481,Assam,85993,417912,595386,724168,503905,31058,1452,60,16/03/2021
571722,1282985,711115,281469,Assam,231490,1332964,1564454,1282985,1282985,144480,1086,148,16/04/2021
300,466,166,0,Assam,42,424,466,238049,466,119,68,0,17/01/2021
96585,128941,32325,5384,Assam,9770,119171,134325,383196,128941,3818,818,31,17/02/2021
194606,513595,318929,93319,Assam,87724,425871,606914,733224,513595,33235,1466,60,17/03/2021
576975,1295462,718336,290719,Assam,236613,1349568,1586181,1295462,1295462,97050,799,151,17/04/2021
461,722,261,0,Assam,63,659,722,234832,722,290,74,0,18/01/2021
98845,135328,36452,7622,Assam,10319,125009,142950,373929,135328,4055,841,31,18/02/2021
200737,530121,329324,97509,Assam,89419,440702,627630,749120,530121,34395,1478,60,18/03/2021
580148,1302992,722692,294473,Assam,239059,1358406,1597465,1302992,1302992,146130,1124,152,18/04/2021
829,1254,425,0,Assam,110,1144,1254,241236,1254,333,78,0,19/01/2021
103359,146695,43305,9857,Assam,10988,135707,156552,397358,146695,4254,850,31,19/02/2021
206428,544125,337637,103009,Assam,90873,453252,647134,762863,544125,36233,1535,60,19/03/2021
601937,1351522,749428,325191,Assam,253460,1423253,1676713,1351522,1351522,328720,2338,157,19/04/2021
829,1254,425,0,Assam,110,1144,1254,242805,1254,408,98,0,20/01/2021
105232,153329,48066,10590,Assam,11769,141560,163919,398959,153329,4402,867,31,20/02/2021
211862,557654,345732,108383,Assam,93010,464644,666037,775815,557654,38119,1676,60,20/03/2021
630597,1415214,784453,355158,Assam,270492,1499880,1770372,1415214,1415214,231990,1776,164,20/04/2021
1390,2163,773,0,Assam,175,1988,2163,246430,2163,493,120,0,21/01/2021
105412,155028,49585,10593,Assam,11955,143073,165621,403021,155028,4620,889,31,21/02/2021
213025,560569,347484,109016,Assam,93324,467245,669585,778325,560569,41632,2022,60,21/03/2021
649068,1454891,805653,369921,Assam,285438,1539374,1824812,1454891,1454891,268650,2048,170,21/04/2021
2608,3947,1339,0,Assam,234,3713,3947,250685,3947,523,132,0,22/01/2021
107319,165031,57680,13879,Assam,14129,150902,178910,403765,165031,4964,912,32,22/02/2021
222211,582391,360119,116252,Assam,95785,486606,698643,801587,582391,44289,2552,61,22/03/2021
673755,1508583,834647,389547,Assam,309712,1588418,1898130,1508583,1508583,265460,2146,181,22/04/2021
2695,4061,1366,0,Assam,247,3814,4061,252828,4061,586,164,0,23/01/2021
109200,174988,65756,15178,Assam,16954,158034,190166,405208,174988,5172,929,32,23/02/2021
282761,702641,419800,125096,Assam,104067,598574,827737,924540,702641,46437,2723,80,23/03/2021
696098,1556972,860686,403837,Assam,342507,1618302,1960809,1556972,1556972,170580,1402,188,23/04/2021
2920,4416,1496,0,Assam,256,4160,4416,255083,4416,647,191,0,24/01/2021
110047,179344,69264,15901,Assam,18978,160366,195245,410594,179344,5659,967,33,24/02/2021
298912,736028,437032,128579,Assam,106670,629358,864607,955036,736028,49301,2748,84,24/03/2021
712939,1592952,879818,412871,Assam,372430,1633393,2005823,1592952,1592952,104270,907,195,24/04/2021
7161,10886,3725,0,Assam,693,10193,10886,259954,10886,675,207,0,25/01/2021
112865,189178,76279,21768,Assam,21808,167370,210946,426319,189178,5937,985,34,25/02/2021
340811,818113,477205,135254,Assam,112401,705712,953367,1038446,818113,51849,2760,97,25/03/2021
718504,1605126,886426,415395,Assam,380857,1639664,2020521,1605126,1605126,94500,797,196,25/04/2021
7258,11021,3763,0,Assam,734,10287,11021,261573,11021,750,236,0,26/01/2021
113879,195376,81463,27758,Assam,24400,170976,223134,451163,195376,6027,990,34,26/02/2021
366510,868321,501708,139806,Assam,118149,750172,1008127,1089912,868321,53158,2767,103,26/03/2021
747089,1664201,916908,440526,Assam,409759,1694968,2104727,1664201,1664201,224700,1774,204,26/04/2021
8129,12407,4278,0,Assam,810,11597,12407,262039,12407,863,277,0,27/01/2021
113879,195376,81463,27758,Assam,24400,170976,223134,451181,195376,6027,990,34,27/02/2021
377777,890467,512587,141400,Assam,121672,768795,1031867,1111271,890467,53627,2770,103,27/03/2021
777398,1728642,951032,463683,Assam,431886,1760439,2192325,1728642,1728642,187600,1502,212,27/04/2021
14472,21430,6957,0,Assam,1478,19952,21430,267033,21430,1001,317,1,28/01/2021
113879,195376,81463,27758,Assam,24400,170976,223134,451184,195376,6104,991,34,28/02/2021
378172,891394,513119,141439,Assam,121752,769642,1032833,1112010,891394,55828,2770,103,28/03/2021
20414,29322,8907,0,Assam,2206,27116,29322,271200,29322,1034,327,1,29/01/2021
379500,894034,514431,141869,Assam,121892,772142,1035903,1114804,894034,58376,2816,103,29/03/2021
21281,30573,9291,0,Assam,2295,28278,30573,272308,30573,1066,343,1,30/01/2021
393586,921564,527866,146565,Assam,126627,794937,1068129,1142539,921564,60412,2838,112,30/03/2021
21379,30688,9308,0,Assam,2295,28393,30688,272958,30688,1112,364,1,31/01/2021
400314,934911,534485,150247,Assam,129202,805709,1085158,1155770,934911,61860,2866,112,31/03/2021
105337,144845,39417,0,Bihar,3467,141378,144845,397301,144845,4647,948,91,01/02/2021
1201435,2376624,1174960,420967,Bihar,79330,2297294,2797591,2607125,2376624,92996,3869,229,01/04/2021
132752,181290,48391,0,Bihar,4692,176598,181290,424169,181290,5363,972,147,02/02/2021
311865,568137,255970,90040,Bihar,31362,536775,658177,746618,568137,17393,1455,302,02/03/2021
1296324,2564430,1267858,427999,Bihar,91481,2472949,2992429,2795603,2564430,96180,4017,248,02/04/2021
162577,219359,56555,0,Bihar,5757,213602,219359,453510,219359,6012,985,227,03/02/2021
315332,581124,265503,108468,Bihar,31913,549211,689592,755237,581124,20006,1513,289,03/03/2021
1356264,2685620,1329095,433659,Bihar,103528,2582092,3119279,2930556,2685620,100340,4101,261,03/04/2021
198416,263973,65324,0,Bihar,6639,257334,263973,477899,263973,6741,1004,233,04/02/2021
321845,598233,276138,135437,Bihar,32277,565956,733670,769365,598233,22092,1526,250,04/03/2021
1460574,2908130,1447277,438709,Bihar,164103,3182736,3346839,2908130,2908130,356850,1683,279,04/04/2021
232234,308439,75944,0,Bihar,7501,300938,308439,495029,308439,7346,1058,261,05/02/2021
329430,618296,288627,159647,Bihar,33396,584900,777943,787747,618296,25186,1542,239,05/03/2021
1521629,3031775,1509853,446835,Bihar,182884,3295726,3478610,3031775,3031775,450951,2517,293,05/04/2021
245029,330327,85030,0,Bihar,8499,321828,330327,514350,330327,7646,1075,268,06/02/2021
339560,643684,303892,184968,Bihar,35203,608481,828652,811322,643684,28705,1557,232,06/03/2021
1615186,3217315,1601821,458828,Bihar,207945,3468198,3676143,3217315,3217315,466920,2674,308,06/04/2021
247277,335765,88219,0,Bihar,8513,327252,335765,529164,335765,8143,1105,269,07/02/2021
340003,644690,304455,185805,Bihar,35231,609459,830495,812479,644690,31237,1793,232,07/03/2021
1756381,3500712,1743992,481257,Bihar,222226,3759743,3981969,3500712,3500712,310600,1958,339,07/04/2021
254327,353743,99142,0,Bihar,9239,344504,353743,545876,353743,8597,1138,274,08/02/2021
440926,784521,343356,212334,Bihar,36110,748411,996855,963709,784521,32474,1833,239,08/03/2021
1836932,3663711,1826420,502092,Bihar,226278,3939525,4165803,3663711,3663711,375950,2107,359,08/04/2021
260776,373801,112731,0,Bihar,10386,363415,373801,566600,373801,8983,1176,294,09/02/2021
474357,847966,373380,233047,Bihar,38693,809273,1081013,1025044,847966,33326,1848,229,09/03/2021
1863961,3721775,1857449,511862,Bihar,228683,4004954,4233637,3721775,3721775,399850,2036,365,09/04/2021
263972,388881,124615,0,Bihar,10755,378126,388881,586793,388881,9350,1219,294,10/02/2021
496909,897173,400039,250493,Bihar,40971,856202,1147666,1073766,897173,34973,1897,225,10/03/2021
1979089,3953983,1974484,537244,Bihar,230671,4260556,4491227,3953983,3953983,529101,3056,410,10/04/2021
268294,409263,140674,0,Bihar,12936,396327,409263,601938,409263,9691,1237,295,11/02/2021
498943,901659,402491,251987,Bihar,41451,860208,1153646,1077781,901659,37430,2157,225,11/03/2021
2096134,4188252,2091666,556503,Bihar,232742,4512013,4744755,4188252,4188252,585150,3164,452,11/04/2021
271953,430554,158306,0,Bihar,16314,414240,430554,622150,430554,10258,1258,295,12/02/2021
543631,1003203,459355,272081,Bihar,43814,959389,1275284,1182176,1003203,39699,2311,217,12/03/2021
2186521,4372599,2185595,579846,Bihar,234507,4717938,4952445,4372599,4372599,496300,2720,483,12/04/2021
278141,451706,173265,55,Bihar,19232,432474,451761,665341,451706,10486,1270,300,13/02/2021
574881,1072779,497712,292378,Bihar,46301,1026478,1365157,1250821,1072779,40781,2330,186,13/03/2021
2226680,4456899,2229729,592446,Bihar,245029,4804316,5049345,4456899,4456899,395852,2219,490,13/04/2021
278376,452936,174260,55,Bihar,19330,433606,452991,679385,452936,10821,1277,300,14/02/2021
576943,1076903,499774,293425,Bihar,46479,1030424,1370328,1254465,1076903,44267,2350,186,14/03/2021
2298095,4608655,2310036,616991,Bihar,255369,4970277,5225646,4608655,4608655,516200,2886,524,14/04/2021
287413,470549,182836,13264,Bihar,20887,449662,483813,688116,470549,10950,1283,300,15/02/2021
605985,1141005,534833,311853,Bihar,47256,1093749,1452858,1321779,1141005,47012,2368,187,15/03/2021
2346892,4714910,2367479,637950,Bihar,269422,5083438,5352860,4714910,4714910,465760,2658,539,15/04/2021
2041,2967,926,0,Bihar,30,2937,2967,298563,2967,222,219,0,16/01/2021
287742,472215,184173,13518,Bihar,21262,450953,485733,698856,472215,11203,1292,300,16/02/2021
633168,1202778,569427,326068,Bihar,50328,1152450,1528846,1381523,1202778,48577,2382,183,16/03/2021
2373969,4774916,2400394,651371,Bihar,281410,5144877,5426287,4774916,4774916,391270,2168,553,16/04/2021
2545,3700,1155,0,Bihar,33,3667,3700,309230,3700,617,304,0,17/01/2021
290400,481352,190652,15155,Bihar,22634,458718,496507,730339,481352,11664,1300,300,17/02/2021
657435,1257644,600035,335880,Bihar,52809,1204835,1593524,1436963,1257644,50165,2412,174,17/03/2021
2427501,4895185,2467117,682821,Bihar,293703,5284303,5578006,4895185,4895185,432820,2612,567,17/04/2021
5728,7883,2155,0,Bihar,40,7843,7883,309572,7883,1037,345,0,18/01/2021
298029,497328,198999,32563,Bihar,24070,473258,529891,707859,497328,12058,1328,300,18/02/2021
687466,1322647,635002,347890,Bihar,53521,1269126,1670537,1503909,1322647,51250,2431,179,18/03/2021
2467783,4984400,2516039,701974,Bihar,301567,5384807,5686374,4984400,4984400,476580,2749,578,18/04/2021
11579,15546,3967,0,Bihar,107,15439,15546,316492,15546,1211,352,0,19/01/2021
303343,512327,208684,34676,Bihar,25385,486942,547003,742233,512327,12417,1330,300,19/02/2021
713582,1379841,666077,357335,Bihar,55855,1323986,1737176,1566049,1379841,53228,2479,182,19/03/2021
2519074,5099038,2579369,737639,Bihar,310307,5526370,5836677,5099038,5099038,509910,2984,595,19/04/2021
12125,16183,4058,0,Bihar,114,16069,16183,317356,16183,1466,369,0,20/01/2021
304562,519360,214498,38402,Bihar,26109,493251,557762,743213,519360,12701,1333,300,20/02/2021
747605,1452705,704924,368077,Bihar,58510,1394195,1820782,1639823,1452705,54756,2501,176,20/03/2021
2561314,5195367,2633442,768720,Bihar,319116,5644971,5964087,5195367,5195367,501070,2974,611,20/04/2021
19297,25254,5957,0,Bihar,283,24971,25254,323972,25254,1575,382,0,21/01/2021
304664,519787,214823,38522,Bihar,26109,493678,558309,743320,519787,12993,1340,300,21/02/2021
758958,1475805,716670,369500,Bihar,58890,1416915,1845305,1657773,1475805,57738,2528,177,21/03/2021
2592230,5265128,2672276,791983,Bihar,324892,5732219,6057111,5265128,5265128,452700,2744,622,21/04/2021
19600,25773,6173,0,Bihar,314,25459,25773,325933,25773,1910,527,0,22/01/2021
305279,523685,218106,55863,Bihar,27294,496391,579548,743611,523685,13263,1348,300,22/02/2021
787706,1536823,748938,375032,Bihar,59318,1477505,1911855,1730879,1536823,61373,2689,179,22/03/2021
2627167,5344307,2716504,825341,Bihar,332830,5836818,6169648,5344307,5344307,480430,3012,636,22/04/2021
28355,38409,10054,0,Bihar,683,37726,38409,333308,38409,2075,597,0,23/01/2021
306291,530477,223886,58405,Bihar,28143,502334,588882,743721,530477,13667,1356,300,23/02/2021
844290,1653860,809389,384932,Bihar,61795,1592065,2038792,1841454,1653860,64514,2917,181,23/03/2021
2658582,5415848,2756624,854934,Bihar,340190,5930592,6270782,5415848,5415848,448930,2793,642,23/04/2021
28599,38787,10188,0,Bihar,739,38048,38787,333750,38787,2168,622,0,24/01/2021
307278,538212,230634,59595,Bihar,29095,509117,597807,743767,538212,14203,1367,300,24/02/2021
892764,1754244,861294,391954,Bihar,64687,1689557,2146198,1944041,1754244,67616,3092,186,24/03/2021
2686679,5480243,2792909,881821,Bihar,347867,6014197,6362064,5480243,5480243,405540,2613,655,24/04/2021
37743,51676,13933,0,Bihar,1152,50524,51676,339535,51676,2290,629,0,25/01/2021
308275,546161,237584,75072,Bihar,29997,516164,621233,744169,546161,14748,1373,302,25/02/2021
952438,1873708,921077,398493,Bihar,65889,1807819,2272201,2066669,1873708,71671,3304,193,25/03/2021
2709931,5534535,2823940,902592,Bihar,352127,6085000,6437127,5534535,5534535,364600,2201,664,25/04/2021
37844,51808,13964,0,Bihar,1161,50647,51808,339889,51808,2407,654,0,26/01/2021
309882,559321,249136,78228,Bihar,31175,528146,637549,741689,559321,14997,1377,303,26/02/2021
1005529,1980495,974762,404098,Bihar,67519,1912976,2384593,2177592,1980495,74229,3389,204,26/03/2021
2745654,5615151,2868822,942706,Bihar,358812,6199045,6557857,5615151,5615151,475830,2970,675,26/04/2021
38561,53222,14661,0,Bihar,1503,51719,53222,340738,53222,2621,697,0,27/01/2021
1060132,2090296,1029955,408451,Bihar,69168,2021128,2498747,2288274,2090296,75897,3438,209,27/03/2021
2776519,5686449,2909244,975341,Bihar,364993,6296797,6661790,5686449,5686449,470380,2991,686,27/04/2021
51298,70412,19113,0,Bihar,1906,68506,70412,347438,70412,2888,773,1,28/01/2021
309882,559321,249136,78228,Bihar,31175,528146,637549,741691,559321,15121,1385,303,28/02/2021
1074527,2118697,1043960,408746,Bihar,69509,2049188,2527443,2315151,2118697,78257,3444,210,28/03/2021
52899,73181,20281,0,Bihar,2355,70826,73181,351177,73181,3235,851,1,29/01/2021
1075916,2121313,1045187,408774,Bihar,69519,2051794,2530087,2317787,2121313,79857,3456,210,29/03/2021
77734,105751,27998,0,Bihar,2781,102970,105751,365771,105751,3662,905,19,30/01/2021
1096982,2164345,1067151,410304,Bihar,70529,2093816,2574649,2363011,2164345,83814,3529,212,30/03/2021
79735,108889,29135,0,Bihar,2844,106045,108889,371504,108889,4003,931,19,31/01/2021
1144883,2262429,1117327,415527,Bihar,73913,2188516,2677956,2465506,2262429,89494,3655,219,31/03/2021
1112,2390,1278,0,Chandigarh,0,2390,2390,20680,2390,106,12,0,01/02/2021
22862,59838,36976,12598,Chandigarh,89,59749,72436,86091,59838,3473,65,0,01/04/2021
1173,2492,1319,0,Chandigarh,0,2492,2492,21150,2492,117,14,0,02/02/2021
5532,19725,14193,1942,Chandigarh,57,19668,21667,49119,19725,690,30,0,02/03/2021
23912,62128,38216,12888,Chandigarh,90,62038,75016,88387,62128,3665,65,0,02/04/2021
1309,2808,1499,0,Chandigarh,0,2808,2808,21913,2808,130,15,0,03/02/2021
6165,21765,15600,2135,Chandigarh,61,21704,23900,50437,21765,1072,36,0,03/03/2021
24995,64519,39524,13342,Chandigarh,91,64428,77861,90997,64519,3820,65,0,03/04/2021
1486,3150,1664,0,Chandigarh,0,3150,3150,22469,3150,145,15,0,04/02/2021
6829,23665,16836,2484,Chandigarh,64,23601,26149,51862,23665,1266,37,0,04/03/2021
30678,77241,46562,13602,Chandigarh,0,90843,90843,77241,77241,6550,44,1,04/04/2021
1650,3511,1861,0,Chandigarh,0,3511,3511,23245,3511,153,16,0,05/02/2021
7621,25595,17974,2802,Chandigarh,66,25529,28397,53537,25595,1407,37,0,05/03/2021
31918,80058,48139,14182,Chandigarh,0,94240,94240,80058,80058,7450,53,1,05/04/2021
1751,3858,2107,0,Chandigarh,0,3858,3858,23826,3858,163,17,0,06/02/2021
8383,27526,19143,3153,Chandigarh,67,27459,30679,55094,27526,1506,39,0,06/03/2021
32494,81444,48949,14567,Chandigarh,0,96011,96011,81444,81444,7650,55,1,06/04/2021
8500,27748,19248,3154,Chandigarh,68,27680,30902,55327,27748,1522,44,0,07/03/2021
34490,85979,51487,15553,Chandigarh,0,101532,101532,85979,85979,7650,54,2,07/04/2021
1830,4189,2359,0,Chandigarh,0,4189,4189,24637,4189,185,17,0,08/02/2021
9361,29863,20502,3613,Chandigarh,69,29794,33476,57293,29863,1592,47,0,08/03/2021
36075,89382,53305,16433,Chandigarh,0,105815,105815,89382,89382,7650,55,2,08/04/2021
1910,4571,2661,0,Chandigarh,0,4571,4571,25397,4571,208,18,0,09/02/2021
10140,31789,21649,4119,Chandigarh,71,31718,35908,59089,31789,1707,51,0,09/03/2021
37635,92814,55177,17335,Chandigarh,0,110149,110149,92814,92814,7650,55,2,09/04/2021
1987,5004,3017,0,Chandigarh,0,5004,5004,26587,5004,228,19,0,10/02/2021
11034,33844,22810,4610,Chandigarh,71,33773,38454,61029,33844,2147,52,0,10/03/2021
39428,96744,57313,18264,Chandigarh,0,115008,115008,96744,96744,7650,55,3,10/04/2021
2115,5480,3365,0,Chandigarh,0,5480,5480,30100,5480,254,20,0,11/02/2021
11393,34558,23165,4697,Chandigarh,77,34481,39255,61713,34558,2239,53,0,11/03/2021
40669,99484,58812,18671,Chandigarh,0,118155,118155,99484,99484,7200,50,3,11/04/2021
2283,6056,3773,0,Chandigarh,1,6055,6056,32038,6056,270,21,0,12/02/2021
12261,36462,24201,5169,Chandigarh,79,36383,41631,63537,36462,2280,56,0,12/03/2021
42118,103131,61010,19810,Chandigarh,0,122941,122941,103131,103131,8200,61,3,12/04/2021
2410,6709,4299,117,Chandigarh,1,6708,6826,33313,6709,290,21,0,13/02/2021
13138,38299,25161,5702,Chandigarh,80,38219,44001,65299,38299,2358,56,0,13/03/2021
43252,106139,62884,20711,Chandigarh,0,126850,126850,106139,106139,8400,62,3,13/04/2021
2411,6712,4301,117,Chandigarh,1,6711,6829,34003,6712,292,21,0,14/02/2021
13196,38409,25213,5773,Chandigarh,80,38329,44182,65409,38409,2396,59,0,14/03/2021
44370,108803,64430,21577,Chandigarh,0,130380,130380,108803,108803,8400,63,3,14/04/2021
2511,7214,4703,118,Chandigarh,2,7212,7332,36527,7214,310,21,0,15/02/2021
14028,40370,26342,6422,Chandigarh,80,40290,46792,67313,40370,2415,59,0,15/03/2021
45535,111665,66127,22898,Chandigarh,0,134563,134563,111665,111665,8800,63,3,15/04/2021
26,120,94,0,Chandigarh,0,120,120,17849,120,5,5,0,16/01/2021
2642,7836,5194,182,Chandigarh,3,7833,8018,37866,7836,327,21,0,16/02/2021
14738,41975,27237,7006,Chandigarh,81,41894,48981,68865,41975,2518,60,0,16/03/2021
46736,114800,68061,24346,Chandigarh,0,139146,139146,114800,114800,8700,63,3,16/04/2021
26,120,94,0,Chandigarh,0,120,120,17856,120,7,5,0,17/01/2021
2728,8364,5636,197,Chandigarh,6,8358,8561,41364,8364,351,21,0,17/02/2021
15444,43486,28042,7490,Chandigarh,81,43405,50976,70323,43486,2607,60,0,17/03/2021
47931,117734,69799,25520,Chandigarh,0,143254,143254,117734,117734,7400,56,4,17/04/2021
42,158,116,0,Chandigarh,0,158,158,16317,158,12,6,0,18/01/2021
2800,8789,5989,398,Chandigarh,8,8781,9187,39368,8789,372,21,0,18/02/2021
16080,44928,28848,7959,Chandigarh,81,44847,52887,71687,44928,2644,60,0,18/03/2021
48678,119500,70818,26100,Chandigarh,0,145600,145600,119500,119500,7200,54,4,18/04/2021
55,165,110,0,Chandigarh,0,165,165,17411,165,12,6,0,19/01/2021
3059,9554,6495,511,Chandigarh,9,9545,10065,46931,9554,397,21,0,19/02/2021
16800,46479,29679,8392,Chandigarh,84,46395,54871,73169,46479,2664,60,0,19/03/2021
49762,122192,72426,27795,Chandigarh,0,149987,149987,122192,122192,8500,64,4,19/04/2021
55,165,110,0,Chandigarh,0,165,165,17451,165,16,6,0,20/01/2021
3241,10379,7138,746,Chandigarh,9,10370,11125,47229,10379,432,21,0,20/02/2021
17436,47831,30395,8836,Chandigarh,85,47746,56667,74473,47831,2687,60,0,20/03/2021
50962,124937,73970,29647,Chandigarh,0,154584,154584,124937,124937,8600,65,5,20/04/2021
99,281,182,0,Chandigarh,0,281,281,17669,281,22,7,0,21/01/2021
3241,10379,7138,746,Chandigarh,9,10370,11125,47771,10379,433,21,0,21/02/2021
17494,47947,30453,8844,Chandigarh,85,47862,56791,74584,47947,2694,60,0,21/03/2021
52205,127635,75424,30930,Chandigarh,0,158565,158565,127635,127635,7900,61,6,21/04/2021
202,507,305,0,Chandigarh,0,507,507,17864,507,31,9,0,22/01/2021
3468,11279,7811,1012,Chandigarh,10,11269,12291,48104,11279,464,22,0,22/02/2021
18073,49231,31158,9385,Chandigarh,85,49146,58616,75876,49231,2786,61,0,22/03/2021
53802,130884,77076,32988,Chandigarh,0,163872,163872,130884,130884,8800,65,6,22/04/2021
339,790,451,0,Chandigarh,0,790,790,18128,790,38,10,0,23/01/2021
3727,12449,8722,1145,Chandigarh,11,12438,13594,48109,12449,493,22,0,23/02/2021
18533,50303,31770,9852,Chandigarh,87,50216,60155,76891,50303,2826,61,0,23/03/2021
55447,134397,78944,35042,Chandigarh,0,169439,169439,134397,134397,8800,66,6,23/04/2021
341,797,456,0,Chandigarh,0,797,797,18684,797,41,10,0,24/01/2021
4062,13675,9613,1214,Chandigarh,18,13657,14889,48117,13675,518,22,0,24/02/2021
18999,51416,32417,10232,Chandigarh,87,51329,61648,77977,51416,2861,62,0,24/03/2021
57322,137994,80666,36727,Chandigarh,0,174721,174721,137994,137994,8300,61,6,24/04/2021
522,1172,650,0,Chandigarh,0,1172,1172,19395,1172,48,10,0,25/01/2021
4425,15100,10675,1479,Chandigarh,45,15055,16579,48128,15100,545,22,0,25/02/2021
19631,52799,33168,10582,Chandigarh,87,52712,63381,79286,52799,2909,63,0,25/03/2021
58746,140795,82042,37860,Chandigarh,0,178655,178655,140795,140795,7000,55,7,25/04/2021
522,1174,652,0,Chandigarh,0,1174,1174,19396,1174,51,12,0,26/01/2021
4780,16927,12147,1640,Chandigarh,54,16873,18567,47730,16927,556,22,0,26/02/2021
20126,53993,33867,10971,Chandigarh,89,53904,64964,80361,53993,2916,63,0,26/03/2021
60402,144305,83896,39947,Chandigarh,0,184252,184252,144305,144305,8400,64,7,26/04/2021
693,1519,826,0,Chandigarh,0,1519,1519,19632,1519,63,12,0,27/01/2021
20717,55188,34471,11247,Chandigarh,89,55099,66435,81502,55188,3013,63,0,27/03/2021
62216,148026,85803,42015,Chandigarh,0,190041,190041,148026,148026,8400,63,7,27/04/2021
841,1821,980,0,Chandigarh,0,1821,1821,19792,1821,79,12,0,28/01/2021
20753,55256,34503,11253,Chandigarh,89,55167,66509,81565,55256,3051,63,0,28/03/2021
858,1874,1016,0,Chandigarh,0,1874,1874,19951,1874,87,12,0,29/01/2021
20768,55283,34515,11259,Chandigarh,89,55194,66542,81590,55283,3080,63,0,29/03/2021
1025,2206,1181,0,Chandigarh,0,2206,2206,20454,2206,90,12,0,30/01/2021
21261,56397,35136,11653,Chandigarh,89,56308,68050,82662,56397,3211,63,0,30/03/2021
1029,2217,1188,0,Chandigarh,0,2217,2217,20467,2217,92,12,0,31/01/2021
21726,57448,35722,12126,Chandigarh,89,57359,69574,83676,57448,3255,63,0,31/03/2021
43857,61482,17621,0,Chhattisgarh,0,61482,61482,255244,61482,1763,337,4,01/02/2021
904468,1759286,854671,324043,Chhattisgarh,13077,1746209,2083329,1895527,1759286,97007,3427,147,01/04/2021
45871,64509,18628,0,Chhattisgarh,0,64509,64509,256214,64509,2057,455,10,02/02/2021
202960,397759,194776,61358,Chhattisgarh,381,397378,459117,503834,397759,18009,1222,23,02/03/2021
1051638,2038560,986755,332669,Chhattisgarh,18152,2020408,2371229,2189162,2038560,109832,3974,167,02/04/2021
63388,86044,22644,0,Chhattisgarh,1,86043,86044,262651,86044,2722,665,12,03/02/2021
211614,417448,205810,71332,Chhattisgarh,389,417059,488780,522334,417448,24441,1316,24,03/03/2021
1163932,2253268,1089147,340005,Chhattisgarh,20765,2232503,2593273,2413195,2253268,118406,4138,189,03/04/2021
88849,115725,26864,0,Chhattisgarh,1,115724,115725,272473,115725,3281,767,12,04/02/2021
225210,445300,220066,88625,Chhattisgarh,402,444898,533925,549522,445300,27388,1366,24,04/03/2021
1349795,2607721,1257700,347234,Chhattisgarh,25994,2928961,2954955,2607721,2607721,413840,3090,226,04/04/2021
105349,135072,29710,0,Chhattisgarh,1,135071,135072,286259,135072,3885,807,13,05/02/2021
239483,474620,235108,103498,Chhattisgarh,419,474201,578118,578637,474620,30892,1407,29,05/03/2021
1408991,2718779,1309547,352752,Chhattisgarh,29139,3042392,3071531,2718779,2718779,410025,3095,241,05/04/2021
120558,153515,32944,0,Chhattisgarh,1,153514,153515,302786,153515,4191,822,13,06/02/2021
258578,512183,253575,120392,Chhattisgarh,425,511758,632575,616014,512183,32769,1433,30,06/03/2021
1458701,2812713,1353760,357866,Chhattisgarh,31947,3138632,3170579,2812713,2812713,428950,3249,252,06/04/2021
120571,153531,32947,0,Chhattisgarh,1,153530,153531,307197,153531,4517,849,13,07/02/2021
259490,514086,254566,120533,Chhattisgarh,425,513661,634619,617857,514086,33919,1443,30,07/03/2021
1573544,3031106,1457287,368310,Chhattisgarh,35471,3363945,3399416,3031106,3031106,387045,3028,275,07/04/2021
131077,168873,37783,0,Chhattisgarh,6,168867,168873,317137,168873,5026,873,13,08/02/2021
278263,551009,272715,133423,Chhattisgarh,433,550576,684432,654562,551009,34767,1458,31,08/03/2021
1726906,3322112,1594896,383446,Chhattisgarh,37403,3668155,3705558,3322112,3322112,487780,3704,310,08/04/2021
137988,182898,44895,0,Chhattisgarh,12,182886,182898,326636,182898,5760,912,15,09/02/2021
293458,581574,288082,144545,Chhattisgarh,464,581110,726119,684819,581574,36025,1475,34,09/03/2021
1841263,3540293,1698686,394865,Chhattisgarh,38895,3896263,3935158,3540293,3540293,487648,3712,344,09/04/2021
146405,201792,55370,0,Chhattisgarh,42,201750,201792,340124,201792,6513,947,17,10/02/2021
312674,619092,306377,159672,Chhattisgarh,471,618621,778764,722296,619092,37436,1512,41,10/03/2021
1934995,3721410,1786056,406399,Chhattisgarh,39557,4088252,4127809,3721410,3721410,442680,3513,359,10/04/2021
152307,218958,66634,0,Chhattisgarh,55,218903,218958,351191,218958,7095,967,17,11/02/2021
314314,622683,308328,160953,Chhattisgarh,497,622186,783636,725763,622683,38642,1521,41,11/03/2021
2020501,3888257,1867373,415407,Chhattisgarh,40226,4263438,4303664,3888257,3888257,468555,3661,383,11/04/2021
156775,234012,77219,0,Chhattisgarh,75,233937,234012,361679,234012,7666,975,18,12/02/2021
330812,656910,326054,176370,Chhattisgarh,504,656406,833280,759375,656910,41406,1587,44,12/03/2021
2093894,4033441,1939150,428925,Chhattisgarh,40711,4421655,4462366,4033441,4033441,471575,3723,397,12/04/2021
160880,248307,87409,862,Chhattisgarh,85,248222,249169,373611,248307,8096,997,18,13/02/2021
352965,700741,347728,191646,Chhattisgarh,505,700236,892387,803013,700741,44246,1663,48,13/03/2021
2136735,4121532,1984387,438207,Chhattisgarh,41359,4518380,4559739,4121532,4121532,446050,3550,410,13/04/2021
160978,249309,88313,926,Chhattisgarh,85,249224,250235,374610,249309,8397,1037,18,14/02/2021
356613,707565,350904,192306,Chhattisgarh,505,707060,899871,809945,707565,46453,1804,48,14/03/2021
2168049,4186570,2018098,447792,Chhattisgarh,42770,4591592,4634362,4186570,4186570,433220,3431,423,14/04/2021
167148,271832,104665,5266,Chhattisgarh,106,271726,277098,393790,271832,8985,1064,19,15/02/2021
388759,770861,382048,208597,Chhattisgarh,583,770278,979458,874581,770861,52035,1876,54,15/03/2021
2185360,4223870,2038086,456357,Chhattisgarh,44276,4635951,4680227,4223870,4223870,407127,3219,424,15/04/2021
515,1040,525,0,Chhattisgarh,0,1040,1040,187856,1040,101,98,0,16/01/2021
171597,287420,115803,6821,Chhattisgarh,107,287313,294241,415503,287420,9620,1096,20,16/02/2021
414600,822237,407578,221905,Chhattisgarh,800,821437,1044142,925544,822237,57093,1988,59,16/03/2021
2211498,4280059,2068132,469555,Chhattisgarh,45939,4703675,4749614,4280059,4280059,420081,3343,429,16/04/2021
515,1040,525,0,Chhattisgarh,0,1040,1040,189047,1040,224,102,0,17/01/2021
175937,302752,126795,9976,Chhattisgarh,119,302633,312728,451829,302752,10310,1106,20,17/02/2021
450126,891234,441042,235167,Chhattisgarh,999,890235,1126401,994666,891234,61128,2065,66,17/03/2021
2258142,4376707,2118121,493467,Chhattisgarh,49014,4821160,4870174,4376707,4376707,425810,3442,444,17/04/2021
930,1656,726,0,Chhattisgarh,0,1656,1656,188790,1656,224,102,0,18/01/2021
177568,315032,137442,14596,Chhattisgarh,151,314881,329628,426595,315032,10912,1112,22,18/02/2021
484481,958410,473859,247555,Chhattisgarh,1439,956971,1205965,1062437,958410,63148,2085,70,18/03/2021
2293502,4448418,2154467,507994,Chhattisgarh,51883,4904529,4956412,4448418,4448418,446210,3559,449,18/04/2021
1147,2014,867,0,Chhattisgarh,0,2014,2014,194571,2014,390,106,0,19/01/2021
183625,331802,148155,16418,Chhattisgarh,198,331604,348220,493039,331802,11530,1116,22,19/02/2021
511788,1012002,500137,258262,Chhattisgarh,1761,1010241,1270264,1118808,1012002,65161,2100,77,19/03/2021
2326738,4516858,2189661,526335,Chhattisgarh,56887,4986306,5043193,4516858,4516858,455020,3642,459,19/04/2021
2008,3351,1343,0,Chhattisgarh,0,3351,3351,197392,3351,542,112,0,20/01/2021
185794,341230,155414,20905,Chhattisgarh,220,341010,362135,493432,341230,11886,1119,22,20/02/2021
547982,1081502,533434,268739,Chhattisgarh,2232,1079270,1350241,1187730,1081502,67411,2114,86,20/03/2021
2348364,4561812,2212981,540894,Chhattisgarh,62145,5040561,5102706,4561812,4561812,451500,3611,467,20/04/2021
3745,5752,2007,0,Chhattisgarh,0,5752,5752,203380,5752,590,117,0,21/01/2021
185826,342208,156360,20936,Chhattisgarh,220,341988,363144,493454,342208,12168,1123,22,21/02/2021
551742,1088317,536489,269621,Chhattisgarh,2271,1086046,1357938,1192058,1088317,69024,2142,86,21/03/2021
2363866,4594052,2229714,552491,Chhattisgarh,66233,5080310,5146543,4594052,4594052,450845,3566,472,21/04/2021
3773,5807,2034,0,Chhattisgarh,0,5807,5807,210568,5807,680,127,0,22/01/2021
188001,351864,163841,28575,Chhattisgarh,232,351632,380439,493592,351864,12648,1125,22,22/02/2021
576140,1136026,559797,277841,Chhattisgarh,2735,1133291,1413867,1243319,1136026,70942,2149,89,22/03/2021
2387299,4642296,2254515,569830,Chhattisgarh,70829,5141297,5212126,4642296,4642296,451621,3625,482,22/04/2021
8292,12185,3892,0,Chhattisgarh,0,12185,12185,217184,12185,803,175,1,23/01/2021
189613,358547,168912,31381,Chhattisgarh,269,358278,389928,493782,358547,13156,1128,22,23/02/2021
594653,1172955,578209,286541,Chhattisgarh,3400,1169555,1459496,1277258,1172955,71891,2151,93,23/03/2021
2408793,4686119,2276833,586615,Chhattisgarh,74984,5197750,5272734,4686119,4686119,453245,3634,493,23/04/2021
8459,12506,4046,0,Chhattisgarh,0,12506,12506,227603,12506,881,211,1,24/01/2021
191605,365643,174016,39529,Chhattisgarh,310,365333,405172,494031,365643,13690,1132,22,24/02/2021
614354,1211306,596853,292518,Chhattisgarh,4164,1207142,1503824,1316008,1211306,73590,2188,99,24/03/2021
2426072,4721290,2294723,602920,Chhattisgarh,78238,5245972,5324210,4721290,4721290,404600,3361,495,24/04/2021
16264,24018,7753,0,Chhattisgarh,0,24018,24018,234843,24018,1015,227,1,25/01/2021
193422,372248,178804,48399,Chhattisgarh,353,371895,420647,494034,372248,14122,1134,22,25/02/2021
641806,1264076,622165,298564,Chhattisgarh,5015,1259061,1562640,1368691,1264076,77702,2350,105,25/03/2021
2438172,4746201,2307527,616146,Chhattisgarh,80052,5282295,5362347,4746201,4746201,374025,3103,502,25/04/2021
16328,24120,7791,0,Chhattisgarh,0,24120,24120,237509,24120,1097,232,1,26/01/2021
194551,376718,182145,51755,Chhattisgarh,371,376347,428473,485507,376718,14139,1134,22,26/02/2021
672626,1322212,649475,302935,Chhattisgarh,6613,1315599,1625147,1428362,1322212,80304,2399,111,26/03/2021
2450519,4772454,2321426,633844,Chhattisgarh,83078,5323220,5406298,4772454,4772454,412765,3332,509,26/04/2021
25162,36363,11198,0,Chhattisgarh,0,36363,36363,244758,36363,1307,260,3,27/01/2021
730014,1429458,699329,306944,Chhattisgarh,8128,1421330,1736402,1535608,1429458,82258,2445,115,27/03/2021
2459515,4791314,2331290,647227,Chhattisgarh,85056,5353485,5438541,4791314,4791314,414000,3367,509,27/04/2021
33062,46869,13804,0,Chhattisgarh,0,46869,46869,249547,46869,1371,268,3,28/01/2021
194551,376718,182145,51755,Chhattisgarh,371,376347,428473,485508,376718,14712,1151,22,28/02/2021
748740,1463205,714348,307403,Chhattisgarh,8564,1454641,1770608,1569462,1463205,84092,2447,117,28/03/2021
33295,47318,14020,0,Chhattisgarh,0,47318,47318,250168,47318,1488,279,3,29/01/2021
749053,1463769,714598,307575,Chhattisgarh,8564,1455205,1771344,1569868,1463769,84628,2484,118,29/03/2021
41082,57446,16360,0,Chhattisgarh,0,57446,57446,253145,57446,1520,280,4,30/01/2021
775949,1514153,738075,311284,Chhattisgarh,9142,1505011,1825437,1620813,1514153,86157,2551,129,30/03/2021
41087,57455,16364,0,Chhattisgarh,0,57455,57455,253254,57455,1608,281,4,31/01/2021
831920,1619232,787173,318058,Chhattisgarh,10638,1608594,1937290,1728883,1619232,88737,2807,139,31/03/2021
562,1038,476,0,Dadra and Nagar Haveli and Daman and Diu,0,1038,1038,2832,1038,35,19,0,01/02/2021
12305,25908,13603,5863,Dadra and Nagar Haveli and Daman and Diu,0,25908,31771,28345,25908,2879,109,0,01/04/2021
616,1181,565,0,Dadra and Nagar Haveli and Daman and Diu,0,1181,1181,3703,1181,49,28,0,02/02/2021
3873,8469,4596,964,Dadra and Nagar Haveli and Daman and Diu,0,8469,9433,10829,8469,807,86,0,02/03/2021
13438,29284,15846,6109,Dadra and Nagar Haveli and Daman and Diu,0,29284,35393,31902,29284,2950,113,0,02/04/2021
770,1421,651,0,Dadra and Nagar Haveli and Daman and Diu,0,1421,1421,3842,1421,64,35,0,03/02/2021
14459,32439,17980,6409,Dadra and Nagar Haveli and Daman and Diu,0,32439,38848,35243,32439,3387,114,0,03/04/2021
935,1681,746,0,Dadra and Nagar Haveli and Daman and Diu,0,1681,1681,4261,1681,77,35,0,04/02/2021
16343,33920,17577,4747,Dadra and Nagar Haveli and Daman and Diu,0,33920,38667,36648,33920,1438,83,0,04/04/2021
1097,1931,834,0,Dadra and Nagar Haveli and Daman and Diu,0,1931,1931,4568,1931,97,35,0,05/02/2021
,,,,Dadra and Nagar Haveli and Daman and Diu,,,0,,,,,,05/04/2021
1341,2255,914,0,Dadra and Nagar Haveli and Daman and Diu,0,2255,2255,4993,2255,114,35,0,06/02/2021
5332,11246,5914,1884,Dadra and Nagar Haveli and Daman and Diu,0,11246,13130,13540,11246,1804,90,0,06/03/2021
5332,11254,5922,1884,Dadra and Nagar Haveli and Daman and Diu,0,11254,13138,13548,11254,1808,90,0,07/03/2021
20119,48313,28194,7716,Dadra and Nagar Haveli and Daman and Diu,0,56029,56029,48313,48313,6950,67,0,07/04/2021
1357,2329,972,0,Dadra and Nagar Haveli and Daman and Diu,0,2329,2329,5228,2329,121,37,0,08/02/2021
5617,11841,6224,2017,Dadra and Nagar Haveli and Daman and Diu,0,11841,13858,14131,11841,1816,91,0,08/03/2021
1407,2567,1160,0,Dadra and Nagar Haveli and Daman and Diu,0,2567,2567,5506,2567,152,49,0,09/02/2021
5843,12275,6432,2261,Dadra and Nagar Haveli and Daman and Diu,0,12275,14536,14551,12275,1836,91,0,09/03/2021
1800,3309,1509,0,Dadra and Nagar Haveli and Daman and Diu,0,3309,3309,5856,3309,176,49,0,10/02/2021
6151,12915,6764,2640,Dadra and Nagar Haveli and Daman and Diu,0,12915,15555,15184,12915,1863,93,0,10/03/2021
24146,59130,34983,8778,Dadra and Nagar Haveli and Daman and Diu,0,67908,67908,59130,59130,7100,71,1,10/04/2021
1981,3672,1691,0,Dadra and Nagar Haveli and Daman and Diu,0,3672,3672,5922,3672,200,49,0,11/02/2021
25224,61498,36272,9025,Dadra and Nagar Haveli and Daman and Diu,0,70523,70523,61498,61498,7350,73,2,11/04/2021
2114,3931,1817,0,Dadra and Nagar Haveli and Daman and Diu,0,3931,3931,6090,3931,222,49,0,12/02/2021
6527,13714,7187,3027,Dadra and Nagar Haveli and Daman and Diu,0,13714,16741,15985,13714,1880,93,0,12/03/2021
2182,4060,1878,71,Dadra and Nagar Haveli and Daman and Diu,0,4060,4131,6235,4060,249,49,0,13/02/2021
6869,14332,7463,3242,Dadra and Nagar Haveli and Daman and Diu,0,14332,17574,16597,14332,1912,94,0,13/03/2021
2305,4347,2042,78,Dadra and Nagar Haveli and Daman and Diu,0,4347,4425,6964,4347,269,49,0,15/02/2021
7272,15038,7766,3527,Dadra and Nagar Haveli and Daman and Diu,0,15038,18565,17298,15038,1970,99,0,15/03/2021
28247,69063,40813,10376,Dadra and Nagar Haveli and Daman and Diu,0,79439,79439,69063,69063,7200,70,3,15/04/2021
10,23,13,0,Dadra and Nagar Haveli and Daman and Diu,0,23,23,1766,23,4,2,0,16/01/2021
2429,4590,2161,164,Dadra and Nagar Haveli and Daman and Diu,0,4590,4754,7908,4590,303,49,0,16/02/2021
7684,15798,8114,3659,Dadra and Nagar Haveli and Daman and Diu,0,15798,19457,18059,15798,1987,99,0,16/03/2021
28768,70628,41857,10848,Dadra and Nagar Haveli and Daman and Diu,0,81476,81476,70628,70628,6600,66,3,16/04/2021
2680,5295,2615,188,Dadra and Nagar Haveli and Daman and Diu,0,5295,5483,8928,5295,334,50,0,17/02/2021
7984,16425,8441,3884,Dadra and Nagar Haveli and Daman and Diu,0,16425,20309,18688,16425,2013,99,0,17/03/2021
29167,71964,42794,11179,Dadra and Nagar Haveli and Daman and Diu,0,83143,83143,71964,71964,6400,63,3,17/04/2021
2704,5569,2865,207,Dadra and Nagar Haveli and Daman and Diu,0,5569,5776,8662,5569,356,50,0,18/02/2021
8227,17413,9186,5435,Dadra and Nagar Haveli and Daman and Diu,0,17413,22848,19889,17413,3194,134,0,18/03/2021
29289,72365,43073,11314,Dadra and Nagar Haveli and Daman and Diu,0,83679,83679,72365,72365,6600,66,3,18/04/2021
16,31,15,0,Dadra and Nagar Haveli and Daman and Diu,0,31,31,1783,31,6,4,0,19/01/2021
2959,6174,3215,330,Dadra and Nagar Haveli and Daman and Diu,0,6174,6504,10120,6174,378,50,0,19/02/2021
8584,17106,8522,3077,Dadra and Nagar Haveli and Daman and Diu,0,17106,20183,19161,17106,1040,64,0,19/03/2021
29546,73240,43691,11705,Dadra and Nagar Haveli and Daman and Diu,0,84945,84945,73240,73240,7000,70,3,19/04/2021
16,31,15,0,Dadra and Nagar Haveli and Daman and Diu,0,31,31,2001,31,8,5,0,20/01/2021
3023,6376,3353,465,Dadra and Nagar Haveli and Daman and Diu,0,6376,6841,10124,6376,406,50,0,20/02/2021
8928,18343,9415,4590,Dadra and Nagar Haveli and Daman and Diu,0,18343,22933,20620,18343,2146,100,0,20/03/2021
30011,74293,44279,12102,Dadra and Nagar Haveli and Daman and Diu,0,86395,86395,74293,74293,6600,66,3,20/04/2021
52,78,26,0,Dadra and Nagar Haveli and Daman and Diu,0,78,78,2269,78,10,7,0,21/01/2021
8953,18391,9438,4600,Dadra and Nagar Haveli and Daman and Diu,0,18391,22991,20660,18391,2156,100,0,21/03/2021
30157,74768,44608,12311,Dadra and Nagar Haveli and Daman and Diu,0,87079,87079,74768,74768,5900,59,3,21/04/2021
68,113,45,0,Dadra and Nagar Haveli and Daman and Diu,0,113,113,2372,113,12,9,0,22/01/2021
9310,19139,9829,4686,Dadra and Nagar Haveli and Daman and Diu,0,19139,23825,21419,19139,2174,103,0,22/03/2021
30429,75414,44982,12677,Dadra and Nagar Haveli and Daman and Diu,0,88091,88091,75414,75414,6700,67,3,22/04/2021
172,280,108,0,Dadra and Nagar Haveli and Daman and Diu,0,280,280,2417,280,13,10,0,23/01/2021
9663,19822,10159,4817,Dadra and Nagar Haveli and Daman and Diu,0,19822,24639,22094,19822,2186,104,0,23/03/2021
30709,76124,45412,13062,Dadra and Nagar Haveli and Daman and Diu,0,89186,89186,76124,76124,6000,60,3,23/04/2021
9942,20398,10456,4888,Dadra and Nagar Haveli and Daman and Diu,0,20398,25286,22674,20398,2198,104,0,24/03/2021
30952,76716,45761,13385,Dadra and Nagar Haveli and Daman and Diu,0,90101,90101,76716,76716,5400,54,3,24/04/2021
220,362,142,0,Dadra and Nagar Haveli and Daman and Diu,0,362,362,2457,362,13,10,0,25/01/2021
10121,20815,10694,5008,Dadra and Nagar Haveli and Daman and Diu,0,20815,25823,23084,20815,2218,105,0,25/03/2021
31038,76905,45864,13545,Dadra and Nagar Haveli and Daman and Diu,0,90450,90450,76905,76905,5300,53,3,25/04/2021
3320,7304,3984,674,Dadra and Nagar Haveli and Daman and Diu,0,7304,7978,9825,7304,497,51,0,26/02/2021
10476,21574,11098,5189,Dadra and Nagar Haveli and Daman and Diu,0,21574,26763,23851,21574,2226,105,0,26/03/2021
31223,77374,46148,14034,Dadra and Nagar Haveli and Daman and Diu,0,91408,91408,77374,77374,6550,65,3,26/04/2021
250,404,154,0,Dadra and Nagar Haveli and Daman and Diu,0,404,404,2459,404,22,16,0,27/01/2021
10700,22084,11384,5271,Dadra and Nagar Haveli and Daman and Diu,0,22084,27355,24358,22084,2252,106,0,27/03/2021
31413,77814,46398,14486,Dadra and Nagar Haveli and Daman and Diu,0,92300,92300,77814,77814,6400,63,3,27/04/2021
314,559,245,0,Dadra and Nagar Haveli and Daman and Diu,0,559,559,2527,559,26,18,0,28/01/2021
395,706,311,0,Dadra and Nagar Haveli and Daman and Diu,0,706,706,2668,706,28,18,0,29/01/2021
10702,22089,11387,5271,Dadra and Nagar Haveli and Daman and Diu,0,22089,27360,24363,22089,2255,106,0,29/03/2021
471,852,381,0,Dadra and Nagar Haveli and Daman and Diu,0,852,852,2734,852,29,19,0,30/01/2021
11060,22707,11647,5510,Dadra and Nagar Haveli and Daman and Diu,0,22707,28217,24979,22707,2262,106,0,30/03/2021
11356,23348,11992,5676,Dadra and Nagar Haveli and Daman and Diu,0,23348,29024,25620,23348,2711,107,0,31/03/2021
24523,52760,28237,0,Delhi,2640,50120,52760,310167,52760,1323,183,0,01/02/2021
260386,743903,483382,261926,Delhi,186572,557331,1005829,967653,743903,50378,825,135,01/04/2021
28791,62086,33295,0,Delhi,3869,58217,62086,313926,62086,1565,185,0,02/02/2021
108053,383386,275223,44991,Delhi,75701,307685,428377,621202,383386,15670,373,110,02/03/2021
276156,778596,502306,266647,Delhi,199934,578662,1045243,1002130,778596,53932,834,134,02/04/2021
32271,69462,37191,0,Delhi,4863,64599,69462,318195,69462,1800,185,0,03/02/2021
111891,394019,282017,49823,Delhi,79096,314923,443842,629527,394019,16429,428,111,03/03/2021
290500,810314,519679,271868,Delhi,211215,599099,1082182,1036033,810314,54831,845,135,03/04/2021
36331,78948,42617,0,Delhi,5969,72979,78948,322744,78948,2001,186,0,04/02/2021
116004,405213,289098,55099,Delhi,82300,322913,460312,639327,405213,19900,442,111,04/03/2021
512765,1290748,777740,287504,Delhi,404762,1173490,1578252,1290748,1290748,92900,735,243,04/04/2021
40359,88045,47686,0,Delhi,6990,81055,88045,330081,88045,2226,186,0,05/02/2021
119819,414969,295038,60620,Delhi,85019,329950,475589,647938,414969,24007,447,112,05/03/2021
541572,1352825,811003,296402,Delhi,429497,1219730,1649227,1352825,1352825,97350,787,250,05/04/2021
43732,97492,53760,0,Delhi,7983,89509,97492,336268,97492,2335,186,0,06/02/2021
124793,426890,301985,68264,Delhi,88221,338669,495154,658484,426890,25956,471,112,06/03/2021
561844,1396046,833942,302735,Delhi,447796,1250985,1698781,1396046,1396046,101850,797,260,06/04/2021
43734,97495,53761,0,Delhi,7983,89512,97495,336272,97495,2404,186,0,07/02/2021
124826,426957,302019,68286,Delhi,88270,338687,495243,658538,426957,26327,490,112,07/03/2021
595813,1469113,873038,315870,Delhi,477505,1307478,1784983,1469113,1469113,66300,480,262,07/04/2021
46474,107116,60642,0,Delhi,9413,97703,107116,344032,107116,2634,187,0,08/02/2021
130214,440429,310101,75759,Delhi,91856,348573,516188,670991,440429,28113,494,114,08/03/2021
641838,1565572,923456,331947,Delhi,515071,1382448,1897519,1565572,1565572,102100,809,278,08/04/2021
49393,119917,70521,0,Delhi,11440,108477,119917,354626,119917,2884,187,3,09/02/2021
135156,453140,317869,84367,Delhi,95284,357856,537507,682736,453140,28727,498,115,09/03/2021
664454,1613146,948404,343540,Delhi,532226,1424460,1956686,1613146,1613146,68250,483,288,09/04/2021
52270,134600,82321,0,Delhi,13731,120869,134600,367782,134600,3193,259,9,10/02/2021
139256,463523,324152,92795,Delhi,97948,365575,556318,692454,463523,28994,500,115,10/03/2021
709088,1705350,995965,357341,Delhi,570732,1491959,2062691,1705350,1705350,105320,803,297,10/04/2021
55255,150348,95078,0,Delhi,16941,133407,150348,386193,150348,3511,263,15,11/02/2021
143158,473832,330559,100481,Delhi,100791,373041,574313,702214,473832,29419,517,115,11/03/2021
742505,1780609,1037794,365110,Delhi,602240,1543479,2145719,1780609,1780609,100310,785,310,11/04/2021
58057,164976,106900,0,Delhi,19955,145021,164976,407264,164976,3832,266,19,12/02/2021
147508,484043,336420,110212,Delhi,103611,380432,594255,711749,484043,29606,534,115,12/03/2021
775235,1855493,1079935,380409,Delhi,635229,1600673,2235902,1855493,1855493,105250,835,323,12/04/2021
60826,178174,117328,1967,Delhi,22509,155665,180141,433592,178174,4045,266,20,13/02/2021
153615,498281,344550,120758,Delhi,107714,390567,619039,725120,498281,29799,541,116,13/03/2021
796535,1912002,1115142,392881,Delhi,661547,1643336,2304883,1912002,1912002,105650,835,325,13/04/2021
60826,178176,117330,1967,Delhi,22510,155666,180143,437552,178176,4153,274,20,14/02/2021
153622,498295,344557,120806,Delhi,107714,390581,619101,725151,498295,29940,546,116,14/03/2021
821419,1971274,1149522,405713,Delhi,688050,1688937,2376987,1971274,1971274,104650,827,333,14/04/2021
63887,192891,128980,4140,Delhi,25669,167222,197031,470122,192891,4496,304,24,15/02/2021
159969,513705,353619,131284,Delhi,112056,401649,644989,739881,513705,30996,550,117,15/03/2021
846567,2031982,1185074,422889,Delhi,716471,1738400,2454871,2031982,2031982,108050,836,341,15/04/2021
367,892,525,0,Delhi,33,859,892,256878,892,91,81,0,16/01/2021
67026,207447,140385,6826,Delhi,28598,178849,214273,536191,207447,4905,311,36,16/02/2021
166005,528084,361961,142569,Delhi,116367,411717,670653,753732,528084,31658,559,118,16/03/2021
860130,2065695,1205218,438376,Delhi,730737,1773334,2504071,2065695,2065695,72850,516,347,16/04/2021
402,1005,603,0,Delhi,36,969,1005,258560,1005,288,81,0,17/01/2021
70390,223511,153075,8033,Delhi,32389,191122,231544,599563,223511,5293,313,46,17/02/2021
170097,537865,367649,151988,Delhi,119249,418616,689853,762898,537865,32246,582,119,17/03/2021
881283,2121099,1239449,451586,Delhi,756067,1816618,2572685,2121099,2121099,105020,803,367,17/04/2021
526,1366,840,0,Delhi,46,1320,1366,248755,1366,347,82,0,18/01/2021
72928,241096,168106,11747,Delhi,38030,203066,252843,480770,241096,5643,314,62,18/02/2021
176179,552643,376344,165766,Delhi,123861,428782,718409,777560,552643,32427,586,120,18/03/2021
897129,2162307,1264802,458970,Delhi,774240,1847037,2621277,2162307,2162307,98950,787,376,18/04/2021
1204,3041,1837,0,Delhi,164,2877,3041,259118,3041,357,83,0,19/01/2021
80618,270025,189330,13604,Delhi,43994,226031,283629,652889,270025,6057,318,77,19/02/2021
180015,561940,381804,176675,Delhi,126529,435411,738615,786816,561940,32919,591,121,19/03/2021
913261,2202752,1289105,479340,Delhi,795593,1886499,2682092,2202752,2202752,103300,827,386,19/04/2021
1204,3041,1837,0,Delhi,164,2877,3041,263673,3041,456,84,0,20/01/2021
86047,291137,205007,18273,Delhi,49981,241156,309410,656758,291137,6263,319,83,20/02/2021
187567,579174,391487,191505,Delhi,131923,447251,770679,803466,579174,33282,597,120,20/03/2021
927296,2238271,1310586,494236,Delhi,813979,1918528,2732507,2238271,2238271,103450,831,389,20/04/2021
2333,5308,2975,0,Delhi,264,5044,5308,277659,5308,528,84,0,21/01/2021
86047,291146,205016,18273,Delhi,49981,241165,309419,656769,291146,6404,319,83,21/02/2021
187935,580060,392005,191767,Delhi,132149,447911,771827,804104,580060,33628,623,120,21/03/2021
945097,2277803,1332312,509313,Delhi,832393,1954723,2787116,2277803,2277803,100950,802,394,21/04/2021
2337,5331,2994,0,Delhi,264,5067,5331,280334,5331,562,84,0,22/01/2021
90810,312680,221784,23864,Delhi,56177,256503,336544,656807,312680,6802,325,86,22/02/2021
194508,595575,400945,205897,Delhi,137186,458389,801472,819810,595575,35518,681,122,22/03/2021
967263,2325997,1358333,529660,Delhi,857044,1998613,2855657,2325997,2325997,104550,823,401,22/04/2021
5668,12312,6644,0,Delhi,550,11762,12312,287790,12312,638,84,0,23/01/2021
94578,330559,235887,26103,Delhi,60898,269661,356662,656810,330559,7190,329,94,23/02/2021
202584,614600,411894,218547,Delhi,143473,471127,833147,837649,614600,36647,713,122,23/03/2021
976915,2347381,1370063,544476,Delhi,866767,2025090,2891857,2347381,2347381,71000,529,403,23/04/2021
5806,12614,6808,0,Delhi,558,12056,12614,289365,12614,648,84,0,24/01/2021
97485,344481,246901,30557,Delhi,64670,279811,375038,656840,344481,7603,329,95,24/02/2021
206898,625107,418086,225879,Delhi,146528,478579,850986,847963,625107,37334,735,123,24/03/2021
999520,2395935,1396008,566296,Delhi,892412,2069819,2962231,2395935,2395935,99450,792,407,24/04/2021
9432,20373,10941,0,Delhi,983,19390,20373,293371,20373,690,84,0,25/01/2021
100290,357350,256955,36121,Delhi,68484,288866,393471,656843,357350,7985,330,105,25/02/2021
215630,645596,429842,234248,Delhi,153335,492261,879844,868285,645596,39416,768,124,25/03/2021
1013331,2425352,1411612,578125,Delhi,904993,2098484,3003477,2425352,2425352,95000,757,409,25/04/2021
9469,20427,10958,0,Delhi,983,19444,20427,293393,20427,745,88,0,26/01/2021
102860,367699,264730,38732,Delhi,71286,296413,406431,610126,367699,8089,330,109,26/02/2021
220109,656156,435922,238844,Delhi,156254,499902,895000,878627,656156,40309,797,125,26/03/2021
1030308,2461970,1431247,599597,Delhi,924779,2136788,3061567,2461970,2461970,99400,805,415,26/04/2021
12708,27603,14895,0,Delhi,1334,26269,27603,296506,27603,859,109,0,27/01/2021
102860,367699,264730,38732,Delhi,71286,296413,406431,610132,367699,8089,330,109,27/02/2021
230522,678689,448042,243316,Delhi,164055,514634,922005,900875,678689,41225,799,125,27/03/2021
1045720,2495676,1449537,619156,Delhi,943088,2171744,3114832,2495676,2495676,98800,799,419,27/04/2021
16520,35881,19361,0,Delhi,1785,34096,35881,300337,35881,961,109,0,28/01/2021
230642,678941,448174,243348,Delhi,164084,514857,922289,901100,678941,41497,801,125,28/03/2021
16549,35937,19388,0,Delhi,1787,34150,35937,301952,35937,1022,109,0,29/01/2021
230656,678976,448195,243360,Delhi,164085,514891,922336,901130,678976,41557,801,125,29/03/2021
20789,44758,23969,0,Delhi,2174,42584,44758,305740,44758,1078,111,0,30/01/2021
240377,700543,460037,249662,Delhi,171570,528973,950205,922911,700543,43808,802,129,30/03/2021
20817,44840,24023,0,Delhi,2176,42664,44840,306271,44840,1119,111,0,31/01/2021
245968,713465,467365,255670,Delhi,175451,538014,969135,935550,713465,45260,811,132,31/03/2021
2403,3860,1457,0,Goa,0,3860,3860,19784,3860,119,60,0,01/02/2021
48412,100100,51684,20126,Goa,2,100098,120226,117558,100100,3910,196,4,01/04/2021
2961,4720,1759,0,Goa,0,4720,4720,20247,4720,148,77,0,02/02/2021
10685,23398,12713,3607,Goa,1,23397,27005,40798,23398,968,157,0,02/03/2021
49665,102851,53182,20697,Goa,2,102849,123548,120061,102851,3986,198,4,02/04/2021
3537,5582,2045,0,Goa,0,5582,5582,20929,5582,158,80,0,03/02/2021
12253,26860,14607,4570,Goa,1,26859,31430,44122,26860,1112,167,0,03/03/2021
50776,105193,54413,21445,Goa,2,105191,126638,122594,105193,4063,198,4,03/04/2021
4193,6532,2339,0,Goa,0,6532,6532,21599,6532,173,83,0,04/02/2021
14019,30673,16654,5497,Goa,1,30672,36170,47861,30673,1258,178,0,04/03/2021
54850,113879,59025,21972,Goa,0,135851,135851,113879,113879,7300,47,4,04/04/2021
4696,7195,2499,0,Goa,0,7195,7195,22257,7195,173,83,0,05/02/2021
15709,34005,18296,6425,Goa,1,34004,40430,51324,34005,1458,178,0,05/03/2021
56176,116633,60453,23113,Goa,0,139746,139746,116633,116633,8700,61,4,05/04/2021
4886,7460,2574,0,Goa,0,7460,7460,22749,7460,182,86,0,06/02/2021
17209,36894,19685,6906,Goa,1,36893,43800,54209,36894,1507,178,0,06/03/2021
57193,118691,61494,23772,Goa,0,142463,142463,118691,118691,9700,70,4,06/04/2021
4886,7462,2576,0,Goa,0,7462,7462,23987,7462,189,89,0,07/02/2021
17216,36902,19686,6906,Goa,1,36901,43808,54229,36902,1532,184,0,07/03/2021
59714,123996,64278,25584,Goa,0,149580,149580,123996,123996,10200,69,4,07/04/2021
5091,7800,2709,0,Goa,0,7800,7800,24657,7800,200,95,0,08/02/2021
18835,40153,21318,7346,Goa,2,40151,47499,57447,40153,1632,184,0,08/03/2021
61814,128428,66610,26948,Goa,0,155376,155376,128428,128428,9400,64,4,08/04/2021
5363,8607,3244,0,Goa,0,8607,8607,25361,8607,214,106,0,09/02/2021
20405,43197,22792,7914,Goa,2,43195,51111,60479,43197,1744,184,0,09/03/2021
63974,133268,69290,28789,Goa,0,162057,162057,133268,133268,8900,64,4,09/04/2021
5657,9656,3999,0,Goa,1,9655,9656,26425,9656,272,115,0,10/02/2021
21739,45860,24121,8768,Goa,2,45858,54628,63151,45860,1957,185,0,10/03/2021
67624,140385,72757,30685,Goa,0,171070,171070,140385,140385,8600,57,4,10/04/2021
6258,11086,4828,0,Goa,1,11085,11086,28245,11086,318,128,0,11/02/2021
22685,48039,25354,9851,Goa,2,48037,57890,65240,48039,2062,186,0,11/03/2021
71021,147178,76153,31151,Goa,0,178329,178329,147178,147178,9600,58,4,11/04/2021
6928,12743,5815,0,Goa,1,12742,12743,30854,12743,357,129,0,12/02/2021
24534,52374,27840,11321,Goa,2,52372,63695,69528,52374,2221,187,0,12/03/2021
74654,154523,79862,33557,Goa,0,188080,188080,154523,154523,18000,65,7,12/04/2021
7170,13277,6107,309,Goa,1,13276,13586,31761,13277,399,131,0,13/02/2021
26246,55795,29549,11708,Goa,2,55793,67503,73037,55795,2268,188,0,13/03/2021
76464,158206,81735,34357,Goa,0,192563,192563,158206,158206,8200,56,7,13/04/2021
7170,13277,6107,309,Goa,1,13276,13586,31762,13277,401,131,0,14/02/2021
26249,55806,29557,11709,Goa,2,55804,67515,73039,55806,2273,189,0,14/03/2021
81290,167443,86145,35682,Goa,0,203125,203125,167443,167443,10500,61,8,14/04/2021
7278,13942,6664,337,Goa,1,13941,14279,33839,13942,419,133,0,15/02/2021
28665,60760,32094,12290,Goa,2,60758,73050,78045,60760,2666,189,1,15/03/2021
84695,173909,89205,39213,Goa,0,213122,213122,173909,173909,10200,59,9,15/04/2021
34,50,16,0,Goa,0,50,50,16349,50,7,7,0,16/01/2021
7303,14123,6820,340,Goa,1,14122,14463,34627,14123,443,134,0,16/02/2021
31264,65813,34548,12677,Goa,2,65811,78490,83115,65813,2902,190,1,16/03/2021
89150,182574,93412,42392,Goa,0,224966,224966,182574,182574,8900,59,12,16/04/2021
34,50,16,0,Goa,0,50,50,16368,50,10,7,0,17/01/2021
7395,14700,7305,340,Goa,1,14699,15040,36560,14700,481,136,0,17/02/2021
32581,68599,36017,13115,Goa,2,68597,81714,85894,68599,2964,190,1,17/03/2021
94085,191878,97780,45278,Goa,0,237156,237156,191878,191878,8800,56,13,17/04/2021
27,47,20,0,Goa,0,47,47,15595,47,20,8,0,18/01/2021
6918,13960,7042,343,Goa,1,13959,14303,33292,13960,507,136,0,18/02/2021
33721,70896,37173,13313,Goa,2,70894,84209,88181,70896,3012,191,2,18/03/2021
97544,198368,100810,46209,Goa,0,244577,244577,198368,198368,7700,52,14,18/04/2021
46,72,26,0,Goa,0,72,72,16266,72,32,15,0,19/01/2021
7679,15417,7738,585,Goa,1,15416,16002,37468,15417,541,137,0,19/02/2021
35096,73609,38511,13845,Goa,2,73607,87454,90934,73609,3029,191,2,19/03/2021
101010,204861,103836,48923,Goa,0,253784,253784,204861,204861,8500,59,15,19/04/2021
36512,76250,39735,14333,Goa,2,76248,90583,93562,76250,3086,193,3,20/03/2021
104778,212256,107462,52107,Goa,0,264363,264363,212256,212256,8500,61,16,20/04/2021
46,72,26,0,Goa,0,72,72,16351,72,41,22,0,21/01/2021
36550,76325,39772,14342,Goa,2,76323,90667,93601,76325,3106,193,3,21/03/2021
107748,218280,110516,54563,Goa,0,272843,272843,218280,218280,9500,65,16,21/04/2021
167,300,133,0,Goa,0,300,300,16660,300,44,24,0,22/01/2021
37933,78995,41059,14855,Goa,2,78993,93850,96277,78995,3344,194,3,22/03/2021
111041,224561,113504,56863,Goa,0,281424,281424,224561,224561,10100,66,16,22/04/2021
577,971,394,0,Goa,0,971,971,17421,971,47,24,0,23/01/2021
39400,81852,42449,15222,Goa,2,81850,97074,99075,81852,3375,194,3,23/03/2021
114157,230437,116263,59251,Goa,0,289688,289688,230437,230437,9200,64,17,23/04/2021
621,1033,412,0,Goa,0,1033,1033,17429,1033,55,26,0,24/01/2021
40668,84430,43759,15839,Goa,2,84428,100269,101625,84430,3394,194,3,24/03/2021
118013,237544,119513,61576,Goa,0,299120,299120,237544,237544,8200,59,18,24/04/2021
794,1285,491,0,Goa,0,1285,1285,17648,1285,68,37,0,25/01/2021
41853,86870,45014,16345,Goa,2,86868,103215,104041,86870,3455,194,3,25/03/2021
120053,241453,121382,62556,Goa,0,304009,304009,241453,241453,4700,43,18,25/04/2021
796,1290,494,0,Goa,0,1290,1290,17860,1290,70,39,0,26/01/2021
9109,19870,10761,2750,Goa,1,19869,22620,37153,19870,726,150,0,26/02/2021
43048,89352,46301,17021,Goa,2,89350,106373,106515,89352,3492,195,3,26/03/2021
123697,248280,124565,64729,Goa,0,313009,313009,248280,248280,8100,58,18,26/04/2021
1160,1844,684,0,Goa,0,1844,1844,18174,1844,72,39,0,27/01/2021
44333,91691,47355,17164,Goa,2,91689,108855,108845,91691,3542,195,3,27/03/2021
127872,256196,128306,67017,Goa,0,323213,323213,256196,256196,9200,63,18,27/04/2021
1504,2394,890,0,Goa,0,2394,2394,18573,2394,77,41,0,28/01/2021
44333,91690,47354,17164,Goa,2,91688,108854,108844,91690,3548,195,3,28/03/2021
1719,2752,1033,0,Goa,0,2752,2752,18968,2752,82,43,0,29/01/2021
44660,92382,47719,17280,Goa,2,92380,109662,109536,92382,3587,195,3,29/03/2021
2135,3464,1329,0,Goa,0,3464,3464,19399,3464,90,46,0,30/01/2021
46119,95240,49118,18377,Goa,2,95238,113617,112432,95240,3837,195,3,30/03/2021
2136,3466,1330,0,Goa,0,3466,3466,19455,3466,103,50,0,31/01/2021
47203,97442,50235,19335,Goa,2,97440,116777,114584,97442,3876,196,4,31/03/2021
150337,284170,133810,0,Gujarat,18250,265920,284170,588003,284170,6317,2635,23,01/02/2021
2441335,5074407,2632609,716500,Gujarat,504315,4570092,5790907,5289086,5074407,271557,14385,463,01/04/2021
157070,306639,149545,0,Gujarat,21694,284945,306639,613839,306639,7267,2796,24,02/02/2021
423099,956419,533263,196848,Gujarat,220193,736226,1153267,1081507,956419,38441,5182,57,02/03/2021
2641237,5516534,2874775,753701,Gujarat,505490,5011044,6270235,5740043,5516534,282315,14648,522,02/04/2021
164556,326450,161870,0,Gujarat,23719,302731,326450,668255,326450,8407,2989,24,03/02/2021
449956,1015619,565605,219274,Gujarat,221149,794470,1234893,1141054,1015619,47141,5391,58,03/03/2021
2791250,5860719,3068911,784038,Gujarat,515106,5345613,6644757,6100900,5860719,292812,14861,558,03/04/2021
180446,360502,180029,0,Gujarat,27569,332933,360502,732651,360502,9897,3278,27,04/02/2021
509268,1143571,634238,254243,Gujarat,223531,920040,1397814,1273158,1143571,58087,5670,65,04/03/2021
3077142,6481838,3404050,831380,Gujarat,743611,6569607,7313218,6481838,6481838,810718,5404,646,04/04/2021
198435,404841,206378,0,Gujarat,45608,359233,404841,780424,404841,11269,3499,28,05/02/2021
575559,1284380,708751,296085,Gujarat,227918,1056462,1580465,1419349,1284380,73367,5873,70,05/03/2021
3189502,6722336,3532159,862632,Gujarat,783722,6801246,7584968,6722336,6722336,940175,6357,675,05/04/2021
216756,448811,232017,0,Gujarat,72262,376549,448811,820280,448811,12250,3591,38,06/02/2021
638102,1414609,776433,330864,Gujarat,233405,1181204,1745473,1551188,1414609,79744,5969,74,06/03/2021
3274818,6904732,3629219,883175,Gujarat,819115,6968792,7787907,6904732,6904732,834618,5701,695,06/04/2021
223877,468838,244923,0,Gujarat,81423,387415,468838,836422,468838,13102,3662,38,07/02/2021
639712,1417812,778026,331788,Gujarat,233455,1184357,1749600,1554078,1417812,82018,6047,74,07/03/2021
3409521,7190429,3780179,918383,Gujarat,895975,7212837,8108812,7190429,7190429,654905,4313,729,07/04/2021
248816,537364,288510,0,Gujarat,115438,421926,537364,860749,537364,14350,3790,38,08/02/2021
704140,1551898,847676,367328,Gujarat,238408,1313490,1919226,1690938,1551898,87832,6170,82,08/03/2021
3557205,7499654,3941673,973697,Gujarat,930838,7542513,8473351,7499654,7499654,1012993,6752,776,08/04/2021
278990,617709,338679,0,Gujarat,160944,456765,617709,886773,617709,15397,3900,40,09/02/2021
764466,1676480,911926,411502,Gujarat,244705,1431775,2087982,1817648,1676480,91441,6267,88,09/03/2021
3672597,7748080,4074678,1024776,Gujarat,949566,7823290,8772856,7748080,7748080,1057645,7110,805,09/04/2021
301749,683599,381805,0,Gujarat,190950,492649,683599,909941,683599,16399,3980,45,10/02/2021
778533,1706767,928141,434278,Gujarat,248431,1458336,2141045,1848257,1706767,94269,6322,93,10/03/2021
3780467,7982633,4201334,1073245,Gujarat,961536,8094342,9055878,7982633,7982633,935843,6038,832,10/04/2021
317662,726174,408466,0,Gujarat,204112,522062,726174,928258,726174,17344,4052,46,11/02/2021
782854,1715866,932918,435497,Gujarat,248640,1467226,2151363,1857436,1715866,96181,6370,94,11/03/2021
3860292,8155231,4294087,1103628,Gujarat,972503,8286356,9258859,8155231,8155231,972497,6260,852,11/04/2021
326839,749435,422549,0,Gujarat,211116,538319,749435,942230,749435,18083,4100,47,12/02/2021
849327,1849842,1000415,485392,Gujarat,255767,1594075,2335234,1994592,1849842,101344,6475,100,12/03/2021
3946587,8342548,4395081,1154965,Gujarat,981293,8516220,9497513,8342548,8342548,1023198,6969,880,12/04/2021
330883,759799,428869,2,Gujarat,213883,545916,759801,954072,759799,18603,4128,47,13/02/2021
901881,1954742,1052756,513975,Gujarat,258755,1695987,2468717,2100156,1954742,105097,6530,105,13/03/2021
4019052,8501205,4481244,1202153,Gujarat,984510,8718848,9703358,8501205,8501205,932485,6404,909,13/04/2021
331397,761549,430105,6,Gujarat,214455,547094,761555,960525,761549,19118,4138,47,14/02/2021
906560,1964307,1057639,515407,Gujarat,258884,1705423,2479714,2109930,1964307,107647,6657,108,14/03/2021
4074221,8622576,4547426,1244211,Gujarat,987663,8879124,9866787,8622576,8622576,989159,6837,929,14/04/2021
337482,774751,437222,8542,Gujarat,215562,559189,783293,971641,774751,19750,4153,47,15/02/2021
971366,2094010,1122529,540451,Gujarat,261240,1832770,2634461,2243388,2094010,111927,6928,115,15/03/2021
4120607,8728318,4606765,1298371,Gujarat,992251,9034438,10026689,8728318,8728318,978239,6765,946,15/04/2021
6400,1146,77814,0,Gujarat,77814,14486,31413,391120,46398,107,95,63,16/01/2021
342111,784610,442452,14686,Gujarat,216205,568405,799296,985010,784610,20206,4182,47,16/02/2021
1035235,2222866,1187499,564874,Gujarat,263329,1959537,2787740,2373731,2222866,115925,7160,132,16/03/2021
4157816,8814264,4655481,1351036,Gujarat,998071,9167229,10165300,8814264,8814264,1014593,6967,967,16/04/2021
1195,2313,1118,0,Gujarat,14,2299,2313,427707,2313,351,189,0,17/01/2021
344545,789722,445130,16703,Gujarat,217132,572590,806425,999923,789722,20766,4213,47,17/02/2021
1053007,2260205,1207060,574765,Gujarat,264184,1996021,2834970,2410425,2260205,121667,8013,138,17/03/2021
4204581,8921355,4715787,1415453,Gujarat,1006242,9330566,10336808,8921355,8921355,940003,6505,987,17/04/2021
1111,2182,1071,0,Gujarat,15,2167,2182,406398,2182,598,287,0,18/01/2021
332846,773109,440215,26414,Gujarat,218356,554753,799523,976418,773109,21378,4239,48,18/02/2021
1138364,2431666,1293143,591203,Gujarat,272162,2159504,3022869,2586253,2431666,128058,8750,159,18/03/2021
4236432,8991639,4754203,1458925,Gujarat,1010942,9439622,10450564,8991639,8991639,949451,6668,1004,18/04/2021
2430,4842,2412,0,Gujarat,15,4827,4842,436502,4842,700,313,0,19/01/2021
352890,807835,454897,35981,Gujarat,218748,589087,843816,1022716,807835,22091,4267,48,19/02/2021
1224188,2603435,1379077,603923,Gujarat,281706,2321729,3207358,2763735,2603435,139023,9845,170,19/03/2021
4277189,9083040,4804830,1537088,Gujarat,1020152,9599976,10620128,9083040,9083040,1029983,7218,1021,19/04/2021
2451,4877,2426,0,Gujarat,18,4859,4877,441359,4877,932,409,0,20/01/2021
353927,810715,456740,58542,Gujarat,219211,591504,869257,1024120,810715,22510,4286,48,20/02/2021
1335713,2824065,1488163,614038,Gujarat,299438,2524627,3438103,2988074,2824065,153285,10643,189,20/03/2021
4320718,9181042,4859276,1625437,Gujarat,1035224,9771255,10806479,9181042,9181042,966204,6823,1048,20/04/2021
4226,8350,4124,0,Gujarat,23,8327,8350,449268,8350,1125,501,0,21/01/2021
354139,810973,456786,59337,Gujarat,219211,591762,870310,1025350,810973,22809,4294,48,21/02/2021
1439423,3028137,1588502,616736,Gujarat,328112,2700025,3644873,3189211,3028137,162839,11104,212,21/03/2021
4352167,9250895,4897672,1686940,Gujarat,1043714,9894121,10937835,9250895,9250895,964950,6858,1056,21/04/2021
6848,13183,6335,0,Gujarat,27,13156,13183,460257,13183,1622,854,0,22/01/2021
355038,812914,457828,72085,Gujarat,219453,593461,884999,1025755,812914,23378,4311,48,22/02/2021
1523207,3193375,1669935,623255,Gujarat,350518,2842857,3816630,3364529,3193375,171892,11684,233,22/03/2021
4387652,9328416,4939698,1769660,Gujarat,1063478,10034598,11098076,9328416,9328416,1000556,6996,1066,22/04/2021
25892,44873,18980,0,Gujarat,31,44842,44873,474762,44873,1724,891,1,23/01/2021
356362,815413,459003,77050,Gujarat,219623,595790,892463,1026791,815413,24005,4317,48,23/02/2021
1655815,3450672,1794600,630637,Gujarat,397089,3053583,4081309,3619161,3450672,180238,12119,257,23/03/2021
4424885,9412213,4986233,1853911,Gujarat,1085356,10180768,11266124,9412213,9412213,963281,6677,1095,23/04/2021
26728,46456,19727,0,Gujarat,33,46423,46456,477088,46456,1901,965,1,24/01/2021
357490,817727,460189,78697,Gujarat,219778,597949,896424,1027162,817727,24982,4326,48,24/02/2021
1744108,3623603,1879211,635450,Gujarat,431328,3192275,4259053,3794975,3623603,190509,12614,284,24/03/2021
4462353,9495699,5032232,1940550,Gujarat,1104672,10331577,11436249,9495699,9495699,796685,5524,1114,24/04/2021
35944,62496,26549,0,Gujarat,35,62461,62496,485891,62496,2019,1005,3,25/01/2021
358593,819845,461204,124015,Gujarat,219919,599926,943860,1027638,819845,25890,4340,48,25/02/2021
1858996,3852063,1992753,639827,Gujarat,464685,3387378,4491890,4027108,3852063,206874,13234,314,25/03/2021
4487467,9549793,5061199,1988068,Gujarat,1117611,10420250,11537861,9549793,9549793,599070,3852,1127,25/04/2021
36060,62729,26666,0,Gujarat,38,62691,62729,487893,62729,2188,1094,3,26/01/2021
359584,821729,462097,167586,Gujarat,220042,601687,989315,941512,821729,26143,4350,48,26/02/2021
1975203,4085850,2110301,644403,Gujarat,494290,3591560,4730253,4267286,4085850,219176,13468,346,26/03/2021
4526440,9634190,5106604,2086642,Gujarat,1133157,10587675,11720832,9634190,9634190,918371,6488,1146,26/04/2021
39679,68817,29135,0,Gujarat,36,68781,68817,496760,68817,3411,1859,3,27/01/2021
2095112,4330566,2235080,647784,Gujarat,501155,3829411,4978350,4512682,4330566,229347,13586,374,27/03/2021
4564947,9718868,5152760,2182385,Gujarat,1147759,10753494,11901253,9718868,9718868,891606,6256,1161,27/04/2021
81152,132621,51456,0,Gujarat,71,132550,132621,521196,132621,4847,2411,13,28/01/2021
359598,821783,462137,167586,Gujarat,220079,601704,989369,941513,821783,28862,4690,48,28/02/2021
2134893,4416669,2281395,648451,Gujarat,501657,3915012,5065120,4599073,4416669,234274,13635,381,28/03/2021
118753,187038,68265,0,Gujarat,77,186961,187038,545239,187038,5520,2523,20,29/01/2021
2141961,4433352,2291009,649088,Gujarat,501710,3931642,5082440,4616133,4433352,237710,13707,382,29/03/2021
134160,211551,77371,0,Gujarat,92,211459,211551,563802,211551,5715,2552,20,30/01/2021
2231922,4617971,2385645,669775,Gujarat,502819,4115152,5287746,4804797,4617971,247966,13846,404,30/03/2021
141964,251207,109220,0,Gujarat,10435,240772,251207,573906,251207,5975,2586,23,31/01/2021
2317304,4802796,2485054,693201,Gujarat,503683,4299113,5495997,4993475,4802796,258624,14091,438,31/03/2021
54844,96304,41457,0,Haryana,3567,92737,96304,238624,96304,3067,1125,3,01/02/2021
664455,1369055,704480,151530,Haryana,199154,1169901,1520585,1526836,1369055,56140,3984,120,01/04/2021
55310,97213,41900,0,Haryana,3567,93646,97213,240357,97213,3169,1130,3,02/02/2021
92198,225787,133584,64929,Haryana,31681,194106,290716,352377,225787,9050,1714,5,02/03/2021
710701,1460950,750119,154894,Haryana,202390,1258560,1615844,1617677,1460950,59899,4022,130,02/04/2021
56425,99192,42764,0,Haryana,3636,95556,99192,243930,99192,3398,1163,3,03/02/2021
93638,229802,136159,66100,Haryana,32541,197261,295902,356144,229802,11173,1811,5,03/03/2021
732909,1506120,773071,156753,Haryana,203568,1302552,1662873,1663614,1506120,62192,4043,140,03/04/2021
58632,103334,44699,0,Haryana,3827,99507,103334,251636,103334,3539,1190,3,04/02/2021
98312,241858,143539,69706,Haryana,36185,205673,311564,367874,241858,13709,1894,7,04/03/2021
795225,1639535,844132,161076,Haryana,236106,1564505,1800611,1639535,1639535,116450,899,178,04/04/2021
59915,107280,47361,0,Haryana,3853,103427,107280,261964,107280,3695,1225,4,05/02/2021
103504,254547,151035,72651,Haryana,38257,216290,327198,380473,254547,16083,1931,8,05/03/2021
834174,1717234,882871,164930,Haryana,238299,1643865,1882164,1717234,1717234,213401,1594,189,05/04/2021
60380,108966,48582,0,Haryana,4114,104852,108966,267166,108966,3890,1284,4,06/02/2021
106712,262058,155338,74423,Haryana,39516,222542,336481,387796,262058,18695,1961,8,06/03/2021
863248,1774869,911424,167327,Haryana,239555,1702641,1942196,1774869,1774869,163560,1228,197,06/04/2021
61089,110591,49498,0,Haryana,4410,106181,110591,275943,110591,4140,1361,4,07/02/2021
107130,263037,155899,74488,Haryana,39918,223119,337525,388812,263037,20207,1977,8,07/03/2021
902869,1855846,952775,172325,Haryana,241762,1786409,2028171,1855846,1855846,136961,955,202,07/04/2021
68448,140415,71963,0,Haryana,11300,129115,140415,288925,140415,4261,1385,4,08/02/2021
116421,285193,168761,79897,Haryana,44751,240442,365090,411310,285193,21567,2021,11,08/03/2021
944092,1939723,995409,178687,Haryana,243696,1874714,2118410,1939723,1939723,189132,1381,222,08/04/2021
71885,157055,85166,0,Haryana,15199,141856,157055,299870,157055,4412,1406,4,09/02/2021
125408,306870,181449,88350,Haryana,49598,257272,395220,432781,306870,22934,2054,13,09/03/2021
985564,2024825,1039028,187427,Haryana,248469,1963783,2212252,2024825,2024825,207931,1529,233,09/04/2021
73971,164151,90176,0,Haryana,16774,147377,164151,310525,164151,4621,1423,4,10/02/2021
129188,316224,187023,91721,Haryana,51918,264306,407945,442170,316224,24483,2079,13,10/03/2021
1016710,2088650,1071694,194612,Haryana,253295,2029967,2283262,2088650,2088650,173950,1254,246,10/04/2021
75660,171926,96262,0,Haryana,18715,153211,171926,321695,171926,4797,1447,4,11/02/2021
132182,323268,191073,93832,Haryana,54057,269211,417100,449013,323268,25620,2136,13,11/03/2021
1063953,2181488,1117273,200626,Haryana,258387,2123727,2382114,2181488,2181488,319191,2183,262,11/04/2021
76541,176310,99765,0,Haryana,19572,156738,176310,329934,176310,4913,1459,4,12/02/2021
145944,354375,208417,100424,Haryana,61172,293203,454799,480722,354375,26691,2204,14,12/03/2021
1127642,2307539,1179606,218295,Haryana,270088,2255746,2525834,2307539,2307539,295422,2187,291,12/04/2021
77201,178067,100862,590,Haryana,19916,158151,178657,334134,178067,5014,1466,4,13/02/2021
152604,368599,215980,102711,Haryana,64629,303970,471310,495122,368599,28212,2385,15,13/03/2021
1183535,2421185,1237344,236085,Haryana,284223,2373047,2657270,2421185,2421185,261440,2041,306,13/04/2021
77205,178074,100865,590,Haryana,19916,158158,178664,334690,178074,5213,1474,4,14/02/2021
154307,372280,217958,103045,Haryana,66016,306264,475325,499037,372280,29575,2588,15,14/03/2021
1243893,2544240,1300023,260744,Haryana,305886,2499098,2804984,2544240,2544240,307328,2345,324,14/04/2021
79005,185578,106569,2904,Haryana,22657,162921,188482,344457,185578,5299,1480,4,15/02/2021
209137,484472,275310,112114,Haryana,106028,378444,596586,616876,484472,31496,2702,25,15/03/2021
1268557,2596134,1327245,277420,Haryana,315598,2557956,2873554,2596134,2596134,217708,1550,332,15/04/2021
844,1864,1020,0,Haryana,113,1751,1864,130131,1864,97,82,0,16/01/2021
79296,186539,107239,3658,Haryana,22754,163785,190197,347685,186539,5383,1484,4,16/02/2021
246404,559527,313086,117343,Haryana,127495,432032,676870,690960,559527,32967,2758,37,16/03/2021
1297497,2657655,1359818,299456,Haryana,326233,2630878,2957111,2657655,2657655,235504,1752,340,16/04/2021
927,2069,1142,0,Haryana,113,1956,2069,130815,2069,299,208,0,17/01/2021
80481,189505,109020,6058,Haryana,23088,166417,195563,351804,189505,5635,1495,4,17/02/2021
254506,577251,322708,120033,Haryana,131508,445743,697284,708374,577251,34454,2888,37,17/03/2021
1319663,2706244,1386238,316382,Haryana,333602,2689024,3022626,2706244,2706244,172100,1307,343,17/04/2021
2606,5360,2754,0,Haryana,231,5129,5360,131608,5360,448,294,0,18/01/2021
81216,193238,112018,12794,Haryana,23808,169430,206032,335205,193238,5895,1499,4,18/02/2021
287854,643349,355446,123665,Haryana,143772,499577,767014,776841,643349,36232,3049,49,18/03/2021
1335205,2740333,1404779,325532,Haryana,339345,2726520,3065865,2740333,2740333,268400,1865,349,18/04/2021
6136,11728,5591,0,Haryana,514,11214,11728,138407,11728,617,396,1,19/01/2021
85189,201383,116190,16787,Haryana,24776,176607,218170,362383,201383,6139,1501,4,19/02/2021
316071,699947,383822,127031,Haryana,151886,548061,826978,838507,699947,37679,3136,54,19/03/2021
1364349,2804924,1440213,357285,Haryana,354736,2807473,3162209,2804924,2804924,250560,1842,362,19/04/2021
6411,12354,5942,0,Haryana,531,11823,12354,141247,12354,869,533,1,20/01/2021
86115,204604,118485,19253,Haryana,25434,179170,223857,362891,204604,6317,1507,4,20/02/2021
327134,722013,394825,128531,Haryana,154427,567586,850544,862105,722013,39315,3303,54,20/03/2021
1389297,2858633,1468968,382699,Haryana,370276,2871056,3241332,2858633,2858633,228150,1687,368,20/04/2021
11614,21411,9796,0,Haryana,758,20653,21411,152254,21411,1109,645,1,21/01/2021
86120,204756,118632,19469,Haryana,25582,179174,224225,364092,204756,6517,1529,4,21/02/2021
329954,727821,397813,128702,Haryana,155362,572459,856523,868381,727821,41213,3396,54,21/03/2021
1404071,2890194,1485750,397220,Haryana,380372,2907042,3287414,2890194,2890194,214974,1495,373,21/04/2021
18718,33730,15011,0,Haryana,1254,32476,33730,160128,33730,1403,776,1,22/01/2021
87149,209690,122537,35101,Haryana,27741,181949,244791,364197,209690,6896,1542,4,22/02/2021
403428,869066,465574,133581,Haryana,168242,700824,1002647,1026538,869066,42805,3490,64,22/03/2021
1422112,2928139,1505643,415867,Haryana,393076,2950930,3344006,2928139,2928139,217940,1570,384,22/04/2021
24097,43350,19252,0,Haryana,1518,41832,43350,172853,43350,1747,884,1,23/01/2021
87631,212356,124720,45400,Haryana,28723,183633,257756,364383,212356,7097,1551,5,23/02/2021
447427,953329,505829,135796,Haryana,176333,776996,1089125,1095268,953329,43633,3520,73,23/03/2021
1448398,2983811,1535024,445927,Haryana,406664,3023074,3429738,2983811,2983811,208280,1538,389,23/04/2021
24776,44934,20157,0,Haryana,1772,43162,44934,178813,44934,2087,996,1,24/01/2021
87794,213246,125447,47090,Haryana,29104,184142,260336,364638,213246,7544,1600,5,24/02/2021
456128,971163,514962,137066,Haryana,178787,792376,1108229,1112569,971163,44711,3544,73,24/03/2021
1471238,3032220,1560587,470541,Haryana,416043,3086718,3502761,3032220,3032220,163528,1346,395,24/04/2021
41624,72277,30651,0,Haryana,2897,69380,72277,197730,72277,2116,1004,2,25/01/2021
89273,217574,128296,58366,Haryana,30031,187543,275940,364774,217574,7733,1615,5,25/02/2021
481447,1021471,539946,139635,Haryana,184064,837407,1161106,1163246,1021471,45958,3568,78,25/03/2021
1484399,3059704,1574902,480171,Haryana,421983,3117892,3539875,3059704,3059704,108570,958,403,25/04/2021
41761,72583,30820,0,Haryana,2898,69685,72583,200702,72583,2205,1030,2,26/01/2021
89522,218507,128980,61666,Haryana,30352,188155,280173,345304,218507,7834,1617,5,26/02/2021
505920,1069220,563217,141742,Haryana,189021,880199,1210962,1213324,1069220,47168,3601,83,26/03/2021
1501681,3096107,1594014,498962,Haryana,432816,3162253,3595069,3096107,3096107,258089,1968,412,26/04/2021
46000,80541,34538,0,Haryana,3093,77448,80541,207596,80541,2445,1070,3,27/01/2021
516636,1090223,573504,142590,Haryana,190681,899542,1232813,1235036,1090223,48322,3658,83,27/03/2021
1513879,3122680,1608384,512225,Haryana,442538,3192367,3634905,3122680,3122680,202500,1575,417,27/04/2021
49743,87153,37407,0,Haryana,3377,83776,87153,217304,87153,2859,1107,3,28/01/2021
89526,218515,128984,61666,Haryana,30352,188163,280181,345325,218515,8055,1642,5,28/02/2021
518274,1093443,575086,142646,Haryana,191411,902032,1236089,1237983,1093443,49059,3689,83,28/03/2021
53117,92685,39565,0,Haryana,3497,89188,92685,228183,92685,2986,1120,3,29/01/2021
518564,1093992,575345,142658,Haryana,191784,902208,1236650,1238489,1093992,49576,3726,83,29/03/2021
54382,95143,40758,0,Haryana,3566,91577,95143,233380,95143,3013,1122,3,30/01/2021
579475,1207369,627792,145892,Haryana,194169,1013200,1353261,1355097,1207369,51452,3858,102,30/03/2021
54406,95245,40836,0,Haryana,3566,91679,95245,234640,95245,3038,1124,3,31/01/2021
626057,1293898,667726,148288,Haryana,197078,1096820,1442186,1442333,1293898,53362,3917,115,31/03/2021
21516,28464,6948,0,Himachal Pradesh,0,28464,28464,86145,28464,889,410,0,01/02/2021
205123,411745,206594,88963,Himachal Pradesh,83,411662,500708,448536,411745,21673,2273,28,01/04/2021
25942,34218,8276,0,Himachal Pradesh,0,34218,34218,87658,34218,978,435,0,02/02/2021
54561,104128,49566,28586,Himachal Pradesh,59,104069,132714,134857,104128,3782,781,1,02/03/2021
212835,426670,213803,89510,Himachal Pradesh,83,426587,516180,461964,426670,22058,2302,32,02/04/2021
29428,38734,9306,0,Himachal Pradesh,0,38734,38734,89207,38734,1124,463,0,03/02/2021
55519,106220,50700,33259,Himachal Pradesh,61,106159,139479,136632,106220,4469,806,1,03/03/2021
218989,439029,220005,90345,Himachal Pradesh,83,438946,529374,476168,439029,22426,2319,35,03/04/2021
32587,43053,10466,0,Himachal Pradesh,0,43053,43053,91225,43053,1201,472,0,04/02/2021
57173,110116,52942,38425,Himachal Pradesh,61,110055,148541,140169,110116,4969,840,1,04/03/2021
268087,539485,271327,91704,Himachal Pradesh,2,631187,631189,539485,539485,26950,234,71,04/04/2021
35212,46401,11189,0,Himachal Pradesh,1,46400,46401,92788,46401,1299,474,0,05/02/2021
60002,116257,56252,42212,Himachal Pradesh,66,116191,158469,146237,116257,5370,858,3,05/03/2021
283855,568597,284671,92962,Himachal Pradesh,2,661557,661559,568597,568597,61900,491,71,05/04/2021
37473,49335,11862,0,Himachal Pradesh,1,49334,49335,96681,49335,1356,483,0,06/02/2021
62255,120892,58634,45023,Himachal Pradesh,66,120826,165915,150866,120892,6133,880,3,06/03/2021
297812,594144,296254,94218,Himachal Pradesh,2,688360,688362,594144,594144,82450,671,78,06/04/2021
37473,49338,11865,0,Himachal Pradesh,1,49337,49338,100581,49338,1419,489,0,07/02/2021
63151,122797,59643,45206,Himachal Pradesh,66,122731,168003,152773,122797,6354,884,3,07/03/2021
343198,677374,334084,97794,Himachal Pradesh,2,775166,775168,677374,677374,67400,555,92,07/04/2021
39981,52715,12734,0,Himachal Pradesh,3,52712,52715,104682,52715,1536,501,0,08/02/2021
65740,128118,62375,48084,Himachal Pradesh,67,128051,176202,158129,128118,7954,910,3,08/03/2021
378478,741610,363032,100199,Himachal Pradesh,2,841807,841809,741610,741610,95050,799,100,08/04/2021
42386,56021,13635,0,Himachal Pradesh,26,55995,56021,108569,56021,1654,551,0,09/02/2021
71956,141523,69562,51464,Himachal Pradesh,70,141453,192987,171701,141523,8893,922,5,09/03/2021
403640,788372,384626,102907,Himachal Pradesh,2,891277,891279,788372,788372,76900,611,106,09/04/2021
42975,60848,17873,0,Himachal Pradesh,26,60822,60848,111776,60848,1780,590,0,10/02/2021
74894,148136,73236,54623,Himachal Pradesh,73,148063,202759,178066,148136,10013,952,6,10/03/2021
430612,837398,406672,105435,Himachal Pradesh,2,942831,942833,837398,837398,76850,641,114,10/04/2021
43797,66825,23028,0,Himachal Pradesh,33,66792,66825,115690,66825,1966,625,0,11/02/2021
75050,148566,73510,54874,Himachal Pradesh,80,148486,203440,178484,148566,11675,1028,6,11/03/2021
451220,876538,425196,107374,Himachal Pradesh,2,983910,983912,876538,876538,76100,624,122,11/04/2021
45637,73945,28307,0,Himachal Pradesh,33,73912,73945,121947,73945,2033,642,1,12/02/2021
80994,161526,80526,61106,Himachal Pradesh,80,161446,222632,191730,161526,13290,1143,6,12/03/2021
485220,940171,454818,111049,Himachal Pradesh,2,1051218,1051220,940171,940171,112850,934,133,12/04/2021
46171,76743,30571,449,Himachal Pradesh,33,76710,77192,125729,76743,2050,642,1,13/02/2021
83369,166370,82994,63182,Himachal Pradesh,80,166290,229552,196384,166370,13974,1233,7,13/03/2021
514043,996913,482731,114950,Himachal Pradesh,2,1111861,1111863,996913,996913,106850,866,139,13/04/2021
46171,76743,30571,449,Himachal Pradesh,33,76710,77192,125744,76743,2097,645,1,14/02/2021
83945,167554,83602,63320,Himachal Pradesh,80,167474,230874,197650,167554,14214,1249,7,14/03/2021
535818,1039677,503714,118201,Himachal Pradesh,2,1157876,1157878,1039677,1039677,105750,908,145,14/04/2021
47133,79084,31950,1868,Himachal Pradesh,33,79051,80952,126342,79084,2179,664,1,15/02/2021
88068,176507,88432,66402,Himachal Pradesh,80,176427,242909,206909,176507,14531,1314,7,15/03/2021
552011,1070578,518419,121952,Himachal Pradesh,2,1192528,1192530,1070578,1070578,80450,677,148,15/04/2021
86,202,116,0,Himachal Pradesh,0,202,202,71601,202,34,30,0,16/01/2021
48161,81911,33749,2807,Himachal Pradesh,33,81878,84718,128229,81911,2292,687,1,16/02/2021
100745,202890,102134,70131,Himachal Pradesh,80,202810,273021,233707,202890,15055,1394,11,16/03/2021
574423,1112736,538160,128855,Himachal Pradesh,2,1241589,1241591,1112736,1112736,78200,645,153,16/04/2021
86,202,116,0,Himachal Pradesh,0,202,202,71708,202,123,89,0,17/01/2021
49664,86419,36754,4197,Himachal Pradesh,33,86386,90616,132079,86419,2444,704,1,17/02/2021
104096,210108,106000,72180,Himachal Pradesh,80,210028,282288,240814,210108,15512,1430,12,17/03/2021
590179,1143738,553402,134355,Himachal Pradesh,2,1278091,1278093,1143738,1143738,66000,546,157,17/04/2021
174,352,178,0,Himachal Pradesh,0,352,352,71146,352,137,91,0,18/01/2021
45676,83703,38026,4917,Himachal Pradesh,34,83669,88620,129227,83703,2581,707,1,18/02/2021
114323,231110,116774,74469,Himachal Pradesh,80,231030,305579,262308,231110,15854,1535,13,18/03/2021
594787,1153059,558113,136443,Himachal Pradesh,2,1289500,1289502,1153059,1153059,41750,328,159,18/04/2021
223,448,225,0,Himachal Pradesh,0,448,448,72045,448,139,91,0,19/01/2021
51266,92440,41173,8208,Himachal Pradesh,34,92406,100648,136335,92440,2682,717,1,19/02/2021
121275,245416,124127,77241,Himachal Pradesh,80,245336,322657,277246,245416,16096,1553,14,19/03/2021
611356,1184950,573430,143710,Himachal Pradesh,2,1328658,1328660,1184950,1184950,82900,703,164,19/04/2021
223,448,225,0,Himachal Pradesh,0,448,448,72151,448,198,119,0,20/01/2021
51730,94569,42838,11831,Himachal Pradesh,38,94531,106400,136417,94569,2761,724,1,20/02/2021
124955,253090,128120,79319,Himachal Pradesh,80,253010,332409,284642,253090,16369,1604,15,20/03/2021
632709,1225885,593001,152805,Himachal Pradesh,2,1378688,1378690,1225885,1225885,89600,730,175,20/04/2021
338,610,272,0,Himachal Pradesh,0,610,610,73121,610,274,160,0,21/01/2021
125617,254397,128765,79460,Himachal Pradesh,80,254317,333857,285912,254397,16543,1615,15,21/03/2021
642140,1244615,602295,156185,Himachal Pradesh,2,1400798,1400800,1244615,1244615,93720,845,180,21/04/2021
918,1427,509,0,Himachal Pradesh,0,1427,1427,74664,1427,338,196,0,22/01/2021
128635,260721,132071,80774,Himachal Pradesh,81,260640,341495,292357,260721,16788,1650,15,22/03/2021
664479,1286057,621388,165345,Himachal Pradesh,2,1451400,1451402,1286057,1286057,95800,824,190,22/04/2021
3917,5396,1479,0,Himachal Pradesh,0,5396,5396,75909,5396,362,207,0,23/01/2021
136995,277566,140555,82580,Himachal Pradesh,82,277484,360146,309630,277566,17234,1719,16,23/03/2021
683510,1322767,639059,175221,Himachal Pradesh,2,1497986,1497988,1322767,1322767,99800,848,198,23/04/2021
4036,5594,1558,0,Himachal Pradesh,0,5594,5594,76519,5594,401,223,0,24/01/2021
52625,98414,45788,12506,Himachal Pradesh,49,98365,110920,136420,98414,3114,746,1,24/02/2021
141358,287058,145683,83527,Himachal Pradesh,83,286975,370585,319107,287058,17866,1847,17,24/03/2021
699681,1354936,655054,182623,Himachal Pradesh,2,1537557,1537559,1354936,1354936,61050,531,201,24/04/2021
4400,6104,1704,0,Himachal Pradesh,0,6104,6104,77664,6104,414,231,0,25/01/2021
53296,100164,46867,16654,Himachal Pradesh,51,100113,116818,136421,100164,3222,748,1,25/02/2021
156533,316973,160419,84551,Himachal Pradesh,83,316890,401524,350069,316973,18500,1947,21,25/03/2021
703782,1363273,659285,185235,Himachal Pradesh,2,1548506,1548508,1363273,1363273,30550,268,206,25/04/2021
4466,6188,1722,0,Himachal Pradesh,0,6188,6188,77995,6188,440,241,0,26/01/2021
53438,100927,47488,20493,Himachal Pradesh,59,100868,121420,132642,100927,3247,748,1,26/02/2021
164567,333201,168612,85759,Himachal Pradesh,83,333118,418960,366312,333201,19205,2059,22,26/03/2021
720981,1396626,675434,196724,Himachal Pradesh,2,1593348,1593350,1396626,1396626,88150,769,211,26/04/2021
6500,8859,2359,0,Himachal Pradesh,0,8859,8859,78308,8859,511,279,0,27/01/2021
172602,349306,176679,86262,Himachal Pradesh,83,349223,435568,382570,349306,19686,2124,25,27/03/2021
740628,1434382,693539,210071,Himachal Pradesh,2,1644451,1644453,1434382,1434382,86150,718,215,27/04/2021
10454,13883,3429,0,Himachal Pradesh,0,13883,13883,80299,13883,565,302,0,28/01/2021
53438,100927,47488,20493,Himachal Pradesh,59,100868,121420,132643,100927,3293,750,1,28/02/2021
173042,350099,177032,86279,Himachal Pradesh,83,350016,436378,383396,350099,19855,2136,25,28/03/2021
13594,17978,4384,0,Himachal Pradesh,0,17978,17978,82051,17978,615,324,0,29/01/2021
173444,350847,177378,86307,Himachal Pradesh,83,350764,437154,384156,350847,20072,2154,25,29/03/2021
17326,22787,5461,0,Himachal Pradesh,0,22787,22787,84385,22787,673,346,0,30/01/2021
184575,372928,188328,87419,Himachal Pradesh,83,372845,460347,406568,372928,20438,2184,25,30/03/2021
188071,380195,192098,88044,Himachal Pradesh,83,380112,468239,414038,380195,20964,2217,26,31/03/2021
2197431,3350265,1152344,0,India,69372,3280893,3350265,10207981,3350265,97432,27751,490,01/02/2021
5131373,11141651,6008960,2419557,India,1244273,9897378,13561208,17917688,11141651,401961,50243,1318,01/03/2021
24825748,52637731,27806633,8898263,India,4771380,47866351,61535994,59583984,52637731,2673997,119512,5350,01/04/2021
2308898,3527971,1218507,0,India,76794,3451177,3527971,10366074,3527971,106461,29522,566,02/02/2021
5422470,11886320,6462436,2647634,India,1277711,10608609,14533954,18560310,11886320,448977,51350,1414,02/03/2021
26294224,55674249,29374352,9105418,India,4964032,50710217,64779667,62638870,55674249,2803969,122375,5673,02/04/2021
2500887,3825835,1324273,0,India,86001,3739834,3825835,10690308,3825835,116568,31167,675,03/02/2021
5692550,12553326,6859318,2830557,India,1307164,11246162,15383883,19150389,12553326,533253,54700,1458,03/03/2021
27522710,58219233,30690586,9300230,India,5127633,53091600,67519463,65428610,58219233,2922034,124323,5937,03/04/2021
2809042,4314304,1504527,0,India,99015,4215289,4314304,11080747,4314304,126714,32505,735,04/02/2021
6045211,13393538,7346850,3142165,India,1345443,12048095,16535703,19931471,13393538,613748,57418,1477,04/03/2021
31665721,66838504,35165269,9567193,India,6880699,69524997,76405697,66838504,66838504,6779834,43542,7514,04/04/2021
3054631,4765924,1710466,0,India,133911,4632013,4765924,11532388,4765924,137110,33947,827,05/02/2021
6490255,14415912,7924084,3455761,India,1386898,13029014,17871673,20921920,14415912,714806,59064,1573,05/03/2021
33052869,69620234,36559511,9819655,India,7162657,72277231,79439889,69620234,69620234,9947093,64960,7854,05/04/2021
3214244,5111827,1896705,0,India,195504,4916323,5111827,11994578,5111827,145121,34814,878,06/02/2021
6948195,15438495,8488627,3732333,India,1434272,14004223,19170828,21888014,15438495,802800,60930,1673,06/03/2021
34255180,72035640,37772299,10029697,India,7419434,74645902,82065337,72035640,72035640,9341151,61096,8161,06/04/2021
3238273,5168099,1928947,0,India,206130,4961969,5168099,12215616,5168099,153231,35778,879,07/02/2021
6993867,15541529,8545982,3747137,India,1440857,14100672,19288666,21983612,15541529,862720,63187,1680,07/03/2021
36552499,76671812,40110598,10428815,India,7832533,79268093,87100627,76671812,76671812,8870978,58826,8715,07/04/2021
3403576,5615499,2211020,0,India,290785,5324714,5615499,12607193,5615499,164116,36740,903,08/02/2021
7676312,16976138,9298005,4062362,India,1495593,15480545,21038500,23420779,16976138,923939,64854,1821,08/03/2021
38715200,80998099,42273620,10883431,India,8167587,83713942,91881530,80998099,80998099,9913258,65506,9279,08/04/2021
3543208,6002474,2458329,0,India,363692,5638782,6002474,12968689,6002474,175556,38131,937,09/02/2021
8132238,17984381,9850241,4372951,India,1557829,16426552,22357332,24428427,17984381,1017231,66317,1902,09/03/2021
40357259,84296847,43929844,11286572,India,8425992,87157426,95583419,84296847,84296847,9969009,65714,9744,09/04/2021
3676114,6462270,2785194,0,India,480760,5981510,6462270,13358469,6462270,187224,39339,962,10/02/2021
8568586,18944399,10373816,4687288,India,1611479,17332920,23631687,25362949,18944399,1149363,68620,1997,10/03/2021
41893575,87411872,45508111,11657482,India,8678151,90391202,99069354,87411872,87411872,8710763,58594,10186,10/04/2021
3803908,6958553,3153649,0,India,609108,6349445,6958553,13831942,6958553,197650,40332,996,11/02/2021
8691411,19213642,10520212,4749703,India,1628133,17585509,23963345,25600158,19213642,1208555,70188,2019,11/03/2021
43205152,90111528,46895781,11888873,India,8865852,93134548,102000401,90111528,90111528,9729980,63648,10595,11/04/2021
3918381,7423817,3504429,0,India,740517,6683300,7423817,14353766,7423817,207633,40799,1007,12/02/2021
9372137,20727869,11353590,5160291,India,1710492,19017377,25888160,27120195,20727869,1294146,71977,2142,12/03/2021
44878560,93559587,48669828,12410952,India,9117558,96852980,105970539,93559587,93559587,10664088,71554,11199,12/04/2021
4002279,7687352,3684053,20859,India,781304,6906048,7708211,14777965,7687352,216559,41308,1020,13/02/2021
9913759,21883802,11967845,5461389,India,1762881,20120921,27345191,28268880,21883802,1349982,73441,2198,13/03/2021
45926378,95823614,49885738,12774675,India,9279181,99319107,108598289,95823614,95823614,10046908,67834,11498,13/04/2021
4009812,7710367,3699535,21911,India,786042,6924325,7732278,14895253,7710367,223423,41606,1020,14/02/2021
9983943,22029912,12043761,5480732,India,1769009,20260903,27510644,28407468,22029912,1400793,75269,2208,14/03/2021
47329847,98703696,51361929,13209592,India,9632303,102280984,111913288,98703696,98703696,10786962,69832,11920,14/04/2021
4184377,8111162,3925723,142489,India,825093,7286069,8253651,15517338,8111162,233527,42016,1062,15/02/2021
10931670,24049536,13115456,5852411,India,1887348,22162188,29901947,30481066,24049536,1480573,77238,2410,15/03/2021
48352489,100853671,52488916,13744355,India,9850203,104747822,114598026,100853671,100853671,9771019,66284,12266,15/04/2021
24517,48276,23757,0,India,579,47697,48276,6943622,48276,3455,2957,2,16/01/2021
4291548,8337600,4044967,239626,India,841412,7496188,8577226,16152472,8337600,245131,42859,1085,16/02/2021
11702117,25684134,13979444,6161333,India,2009264,23674870,31845467,32090765,25684134,1551534,79098,2573,16/03/2021
49339504,102927296,53575244,14378048,India,10178643,107126700,117305344,102927296,102927296,9780485,66381,12548,16/04/2021
31252,58604,27348,0,India,635,57969,58604,7119567,58604,8532,4954,4,17/01/2021
4432078,8704698,4271486,318541,India,894555,7810143,9023239,16867476,8704698,256706,43310,1134,17/02/2021
12471427,27299603,14825466,6484692,India,2118298,25181305,33784295,33710122,27299603,1612319,81808,2710,17/03/2021
50289664,104950409,54647827,15020960,India,10555424,109415944,119971369,104950409,104950409,8521217,60057,12918,17/04/2021
58083,99449,41361,0,India,1299,98150,99449,7150780,99449,13611,6583,5,18/01/2021
4351815,8862491,4509554,475776,India,962251,7900240,9338267,16357801,8862491,268275,43734,1122,18/02/2021
13296354,29093763,15794523,6829737,India,2270721,26823042,35923500,35521998,29093763,1671073,85645,2886,18/03/2021
50732172,105896430,55151208,15310668,India,10711610,110495487,121207098,105896430,105896430,8395934,58212,13050,18/04/2021
113613,195525,81901,0,India,3017,192508,195525,7423057,195525,17855,7951,11,19/01/2021
4702310,9523567,4820055,717941,India,1003518,8520049,10241508,17807727,9523567,279055,44167,1202,19/02/2021
14266785,31109369,16839488,7080818,India,2423450,28685919,38190187,37651803,31109369,1748598,90343,3096,19/03/2021
51806475,108178574,56358692,16278588,India,11106751,113350410,124457162,108178574,108178574,10632658,73506,13407,19/04/2021
153145,251280,98111,0,India,3946,247334,251280,7555207,251280,25472,10504,24,20/01/2021
4766532,9734505,4966750,884608,India,1033170,8701335,10619113,18021113,9734505,288334,44791,1223,20/02/2021
15310682,33244339,17930376,7308863,India,2640329,30604010,40553202,39786871,33244339,1823541,93171,3281,20/03/2021
52731510,110165234,57420010,17263653,India,11515707,115913179,127428887,110165234,110165234,10163007,71051,13714,20/04/2021
233143,365965,132784,0,India,5367,360598,365965,7755870,365965,32226,12600,38,21/01/2021
4773924,9757217,4982068,893795,India,1037565,8719652,10651012,18179792,9757217,299726,45120,1225,21/02/2021
15668395,33954019,18282253,7341897,India,2726019,31228000,41295916,40408645,33954019,1887451,95661,3371,21/03/2021
53441979,111673361,58217380,17972744,India,11799916,117846188,129646105,111673361,111673361,9537781,67123,14002,21/04/2021
355402,549381,193899,0,India,8128,541253,549381,8058775,549381,36988,14115,80,22/01/2021
4841511,10069263,5226538,1174416,India,1085940,8983323,11243679,18342215,10069263,312382,45490,1214,22/02/2021
16698587,36082737,19380549,7592002,India,2977493,33105244,43674739,42766076,36082737,1959895,98704,3601,22/03/2021
54355513,113584269,59214377,19170339,India,12176768,120577839,132754608,113584269,113584269,10459336,73933,14379,22/04/2021
491049,759008,267856,0,India,11192,747816,759008,8314768,759008,43076,15605,103,23/01/2021
4897627,10288293,5389434,1309475,India,1120345,9167948,11597768,18402147,10288293,325527,46054,1232,23/02/2021
17860594,38442719,20578314,7824187,India,3304795,35137924,46266906,44958723,38442719,2018346,101134,3811,23/03/2021
55237448,115461202,60208977,20197122,India,12507127,123151196,135658324,115461202,115461202,9772224,68575,14777,23/04/2021
538647,835058,296283,0,India,13156,821902,835058,8443150,835058,49851,18111,128,24/01/2021
4957351,10517568,5558978,1525390,India,1156820,9360748,12042958,18459495,10517568,339617,46671,1239,24/02/2021
18829307,40414580,21581261,7965930,India,3599196,36815384,48380510,46952251,40414580,2076874,103187,4012,24/03/2021
56011474,117105343,61078797,21080613,India,12775153,125410802,138185956,117105343,117105343,8300170,59612,15072,24/04/2021
832766,1277104,444137,0,India,18858,1258246,1277104,8802225,1277104,55151,19682,201,25/01/2021
5045426,10846192,5799474,1972882,India,1204424,9641768,12819074,18523988,10846192,352882,47068,1292,25/02/2021
19793110,42415793,22618412,8134379,India,3855726,38560067,50550172,48965377,42415793,2150505,105650,4271,25/03/2021
56337692,117795008,61442119,21390165,India,12866845,126318327,139185173,117795008,117795008,5844983,41927,15197,25/04/2021
844448,1293784,449119,0,India,19604,1274180,1293784,8884622,1293784,60821,21467,217,26/01/2021
5131299,11141375,6008758,2419557,India,1244235,9897140,13560932,17915124,11141375,357440,47240,1318,26/02/2021
20842900,44551939,23704536,8271738,India,4111710,40440229,52823677,51164359,44551939,2211254,107311,4503,26/03/2021
57335805,119886252,62534884,22638695,India,13127022,129397924,142524947,119886252,119886252,9725885,68905,15563,26/04/2021
1140137,1726490,586081,0,India,27377,1699113,1726490,9119686,1726490,69495,23737,272,27/01/2021
5131323,11141426,6008785,2419557,India,1244235,9897191,13560983,17916598,11141426,357450,47242,1318,27/02/2021
21813991,46506675,24687983,8370005,India,4293429,42213246,54876680,53103210,46506675,2261887,108347,4701,27/03/2021
57980903,121263287,63266613,23615946,India,13362545,131516688,144879233,121263287,121263287,9192384,65370,15771,27/04/2021
1523939,2295491,771229,0,India,36921,2258570,2295491,9420417,2295491,78523,25610,323,28/01/2021
5131373,11141651,6008960,2419557,India,1244273,9897378,13561208,17917681,11141651,367595,48032,1318,28/02/2021
21959477,46803472,24839264,8377403,India,4310791,42492681,55180875,53387713,46803472,2300682,108992,4731,28/03/2021
1875368,2814803,939069,0,India,43604,2771199,2814803,9731289,2814803,83664,26219,366,29/01/2021
22222402,47318251,25091064,8408267,India,4376512,42941739,55726518,53910256,47318251,2344458,109754,4785,29/03/2021
2044950,3067736,1022380,0,India,48300,3019436,3067736,9950757,3067736,87822,26643,406,30/01/2021
22966152,48810624,25839520,8553238,India,4489546,44321078,57363862,55430088,48810624,2433579,112112,4952,30/03/2021
2065391,3127107,1061307,0,India,58890,3068217,3127107,10025789,3127107,91593,27011,409,31/01/2021
23772999,50448857,26670710,8727510,India,4614874,45833983,59176367,57097935,50448857,2550671,115798,5148,31/03/2021
11878,21322,9440,0,Jammu and Kashmir,0,21322,21322,232525,21322,1081,250,4,01/02/2021
202317,655150,452711,159200,Jammu and Kashmir,1705,653445,814350,803400,655150,53653,1426,122,01/04/2021
11900,21352,9448,0,Jammu and Kashmir,0,21352,21352,232657,21352,1203,278,4,02/02/2021
49547,241454,191829,17269,Jammu and Kashmir,1178,240276,258723,399147,241454,9022,713,78,02/03/2021
217043,689834,472665,163975,Jammu and Kashmir,1709,688125,853809,837734,689834,54866,1465,126,02/04/2021
11975,21478,9499,0,Jammu and Kashmir,0,21478,21478,232676,21478,1406,356,4,03/02/2021
49781,243610,193749,17367,Jammu and Kashmir,1189,242421,260977,400480,243610,12250,831,80,03/03/2021
228731,717839,488974,167916,Jammu and Kashmir,1717,716122,885755,867552,717839,56675,1478,134,03/04/2021
14856,27796,12935,0,Jammu and Kashmir,0,27796,27796,236783,27796,1695,384,5,04/02/2021
53550,257976,204346,19208,Jammu and Kashmir,1227,256749,277184,413347,257976,13502,900,80,04/03/2021
256262,764873,508463,161537,Jammu and Kashmir,0,926410,926410,764873,764873,123700,994,148,04/04/2021
17114,33899,16780,0,Jammu and Kashmir,0,33899,33899,241292,33899,1923,402,5,05/02/2021
57779,272803,214941,21756,Jammu and Kashmir,1249,271554,294559,426985,272803,21125,955,83,05/03/2021
272287,799804,527366,165214,Jammu and Kashmir,0,965018,965018,799804,799804,151100,1234,151,05/04/2021
19138,40909,21766,0,Jammu and Kashmir,0,40909,40909,247473,40909,2022,408,5,06/02/2021
63213,288844,225545,25105,Jammu and Kashmir,1260,287584,313949,442597,288844,27290,975,86,06/03/2021
287111,831857,544586,168216,Jammu and Kashmir,0,1000073,1000073,831857,831857,139050,1183,160,06/04/2021
19293,41543,22245,0,Jammu and Kashmir,0,41543,41543,250272,41543,2382,425,5,07/02/2021
63266,289112,225760,25125,Jammu and Kashmir,1260,287852,314237,442810,289112,30859,1053,86,07/03/2021
321876,909465,587413,174198,Jammu and Kashmir,0,1083663,1083663,909465,909465,147750,1244,176,07/04/2021
22078,51872,29785,0,Jammu and Kashmir,4,51868,51872,260990,51872,2619,440,9,08/02/2021
70281,309309,238939,30666,Jammu and Kashmir,1303,308006,339975,462559,309309,32745,1095,89,08/03/2021
360947,994678,633548,182428,Jammu and Kashmir,0,1177106,1177106,994678,994678,170203,1370,183,08/04/2021
24551,63529,38969,0,Jammu and Kashmir,12,63517,63529,272002,63529,2746,443,9,09/02/2021
77793,331895,254012,37394,Jammu and Kashmir,1367,330528,369289,484480,331895,33608,1113,90,09/03/2021
387357,1053587,666037,186812,Jammu and Kashmir,0,1240399,1240399,1053587,1053587,171700,1417,193,09/04/2021
24886,65779,40884,0,Jammu and Kashmir,58,65721,65779,278490,65779,3070,481,9,10/02/2021
78025,333222,255107,37879,Jammu and Kashmir,1396,331826,371101,485330,333222,35154,1131,90,10/03/2021
406597,1095604,688808,190725,Jammu and Kashmir,0,1286329,1286329,1095604,1095604,142250,1212,199,10/04/2021
27807,83295,55476,0,Jammu and Kashmir,72,83223,83295,286407,83295,3397,493,12,11/02/2021
78377,334500,256033,38233,Jammu and Kashmir,1468,333032,372733,486334,334500,35692,1134,90,11/03/2021
422217,1128724,706302,192990,Jammu and Kashmir,0,1321714,1321714,1128724,1128724,169900,1423,205,11/04/2021
30236,100823,70575,0,Jammu and Kashmir,218,100605,100823,303762,100823,3731,510,12,12/02/2021
78624,335917,257203,40735,Jammu and Kashmir,1499,334418,376652,487498,335917,36688,1147,90,12/03/2021
450063,1190462,740183,199609,Jammu and Kashmir,0,1390071,1390071,1190462,1190462,182102,1499,216,12/04/2021
32503,117677,85162,722,Jammu and Kashmir,263,117414,118399,318010,117677,3883,514,12,13/02/2021
87885,362666,274689,56214,Jammu and Kashmir,1506,361160,418880,513471,362666,37210,1164,92,13/03/2021
461685,1217666,755761,202914,Jammu and Kashmir,0,1420580,1420580,1217666,1217666,144250,1256,220,13/04/2021
32621,118293,85660,722,Jammu and Kashmir,279,118014,119015,325077,118293,4291,521,12,14/02/2021
88048,363229,275089,56550,Jammu and Kashmir,1506,361723,419779,513910,363229,37758,1184,92,14/03/2021
474584,1245840,771032,206799,Jammu and Kashmir,0,1452639,1452639,1245840,1245840,176050,1460,224,14/04/2021
34959,134369,99398,1663,Jammu and Kashmir,479,133890,136032,338130,134369,4607,529,12,15/02/2021
97771,390431,292565,70584,Jammu and Kashmir,1527,388904,461015,540800,390431,38590,1215,95,15/03/2021
492963,1285404,792215,214736,Jammu and Kashmir,0,1500140,1500140,1285404,1285404,179200,1470,226,15/04/2021
141,377,236,0,Jammu and Kashmir,0,377,377,113625,377,38,37,0,16/01/2021
36881,148004,111111,2267,Jammu and Kashmir,480,147524,150271,363114,148004,4717,542,12,16/02/2021
107664,416994,309230,83839,Jammu and Kashmir,1549,415445,500833,566025,416994,39128,1226,100,16/03/2021
509377,1322027,812420,222389,Jammu and Kashmir,0,1544416,1544416,1322027,1322027,179408,1484,230,16/04/2021
153,421,268,0,Jammu and Kashmir,0,421,421,158151,421,101,40,0,17/01/2021
37051,148878,111815,2267,Jammu and Kashmir,512,148366,151145,372409,148878,5039,552,12,17/02/2021
108106,418542,310335,84708,Jammu and Kashmir,1578,416964,503250,567287,418542,39769,1248,101,17/03/2021
525472,1358605,832897,230383,Jammu and Kashmir,0,1588988,1588988,1358605,1358605,157750,1381,236,17/04/2021
274,672,398,0,Jammu and Kashmir,0,672,672,155563,672,186,45,0,18/01/2021
38290,163037,124729,3392,Jammu and Kashmir,634,162403,166429,350960,163037,5380,557,18,18/02/2021
118080,445910,327725,97784,Jammu and Kashmir,1586,444324,543694,593928,445910,40451,1263,105,18/03/2021
537439,1386560,848883,235537,Jammu and Kashmir,0,1622097,1622097,1386560,1386560,175508,1468,238,18/04/2021
601,1369,768,0,Jammu and Kashmir,0,1369,1369,166335,1369,242,55,0,19/01/2021
41144,176551,135381,4941,Jammu and Kashmir,727,175824,181492,393734,176551,5676,558,26,19/02/2021
123323,459633,336204,105645,Jammu and Kashmir,1601,458032,565278,607346,459633,40940,1265,106,19/03/2021
561147,1439317,877926,248756,Jammu and Kashmir,0,1688073,1688073,1439317,1439317,181000,1509,244,19/04/2021
601,1369,768,0,Jammu and Kashmir,0,1369,1369,174493,1369,322,76,0,20/01/2021
42965,186097,143103,6258,Jammu and Kashmir,836,185261,192355,394609,186097,5817,566,29,20/02/2021
126909,469881,342865,111101,Jammu and Kashmir,1617,468264,580982,616837,469881,41321,1267,107,20/03/2021
585130,1492291,906912,260658,Jammu and Kashmir,0,1752949,1752949,1492291,1492291,161950,1421,249,20/04/2021
923,2296,1373,0,Jammu and Kashmir,0,2296,2296,184188,2296,412,91,0,21/01/2021
43020,186304,143255,6277,Jammu and Kashmir,839,185465,192581,394938,186304,6243,585,29,21/02/2021
127246,471049,343695,111770,Jammu and Kashmir,1644,469405,582819,617773,471049,42038,1292,108,21/03/2021
602999,1532708,929452,268455,Jammu and Kashmir,0,1801163,1801163,1532708,1532708,175050,1484,257,21/04/2021
1743,3807,2064,0,Jammu and Kashmir,0,3807,3807,192776,3807,500,105,0,22/01/2021
44247,195331,151055,8862,Jammu and Kashmir,885,194446,204193,394974,195331,6521,591,29,22/02/2021
134836,490817,355873,121729,Jammu and Kashmir,1654,489163,612546,637687,490817,42623,1303,108,22/03/2021
622746,1576508,953499,279942,Jammu and Kashmir,0,1856450,1856450,1576508,1576508,183350,1541,263,22/04/2021
2676,5593,2917,0,Jammu and Kashmir,0,5593,5593,199446,5593,544,126,0,23/01/2021
45083,202132,157010,9943,Jammu and Kashmir,1049,201083,212075,395082,202132,6605,591,39,23/02/2021
142514,510709,368085,129882,Jammu and Kashmir,1666,509043,640591,656372,510709,42932,1309,110,23/03/2021
647259,1632265,984732,292261,Jammu and Kashmir,0,1924526,1924526,1632265,1632265,185550,1562,274,23/04/2021
2822,5893,3071,0,Jammu and Kashmir,0,5893,5893,205869,5893,630,155,0,24/01/2021
45103,202749,157607,9953,Jammu and Kashmir,1083,201666,212702,395105,202749,6969,591,39,24/02/2021
142759,511788,368919,131016,Jammu and Kashmir,1670,510118,642804,657200,511788,43643,1334,110,24/03/2021
674843,1691210,1016079,305511,Jammu and Kashmir,0,1996721,1996721,1691210,1691210,165150,1474,288,24/04/2021
5384,10498,5113,0,Jammu and Kashmir,0,10498,10498,220685,10498,649,160,1,25/01/2021
46192,213201,166950,12886,Jammu and Kashmir,1106,212095,226087,395269,213201,7234,592,59,25/02/2021
153684,539260,385463,138081,Jammu and Kashmir,1674,537586,677341,684903,539260,44263,1351,113,25/03/2021
693824,1731283,1037167,311925,Jammu and Kashmir,0,2043208,2043208,1731283,1731283,178650,1544,292,25/04/2021
5450,10626,5175,0,Jammu and Kashmir,0,10626,10626,221426,10626,693,171,1,26/01/2021
46926,222386,175387,15687,Jammu and Kashmir,1125,221261,238073,386782,222386,7267,593,73,26/02/2021
162988,561747,398645,142403,Jammu and Kashmir,1683,560064,704150,707743,561747,44846,1358,114,26/03/2021
725177,1798206,1072720,327437,Jammu and Kashmir,0,2125643,2125643,1798206,1798206,190108,1626,309,26/04/2021
5912,11562,5649,0,Jammu and Kashmir,0,11562,11562,224627,11562,843,219,1,27/01/2021
46926,222386,175387,15687,Jammu and Kashmir,1125,221261,238073,386873,222386,7267,593,73,27/02/2021
171987,582995,410892,145988,Jammu and Kashmir,1685,581310,728983,728583,582995,45213,1362,116,27/03/2021
748619,1848389,1099445,338505,Jammu and Kashmir,0,2186894,2186894,1848389,1848389,172050,1533,325,27/04/2021
9373,17280,7905,0,Jammu and Kashmir,0,17280,17280,229032,17280,1021,243,2,28/01/2021
172359,583898,411423,146088,Jammu and Kashmir,1685,582213,729986,729339,583898,46738,1374,116,28/03/2021
11787,21124,9333,0,Jammu and Kashmir,0,21124,21124,231554,21124,1026,243,4,29/01/2021
180938,604676,423619,149837,Jammu and Kashmir,1685,602991,754513,750447,604676,47984,1386,119,29/03/2021
11849,21261,9408,0,Jammu and Kashmir,0,21261,21261,232317,21261,1039,243,4,30/01/2021
190212,626668,436335,154560,Jammu and Kashmir,1685,624983,781228,772401,626668,49018,1391,121,30/03/2021
11853,21268,9411,0,Jammu and Kashmir,0,21268,21268,232401,21268,1053,247,4,31/01/2021
190673,627951,437157,154983,Jammu and Kashmir,1701,626250,782934,773497,627951,51277,1408,121,31/03/2021
28260,39147,10887,0,Jharkhand,20,39127,39147,194726,39147,1573,274,0,01/02/2021
704128,1415660,711426,252097,Jharkhand,161443,1254217,1667757,1541251,1415660,74681,4743,106,01/04/2021
34158,46900,12742,0,Jharkhand,139,46761,46900,198712,46900,1754,295,0,02/02/2021
140414,300236,159817,32050,Jharkhand,29427,270809,332286,399460,300236,11146,608,5,02/03/2021
720444,1449935,729380,255860,Jharkhand,162943,1286992,1705795,1576360,1449935,77165,4774,111,02/04/2021
43235,58991,15756,0,Jharkhand,315,58676,58991,204511,58991,1975,314,0,03/02/2021
145277,312092,166810,38624,Jharkhand,31379,280713,350716,410452,312092,12106,638,5,03/03/2021
731241,1473689,742336,259312,Jharkhand,163627,1310062,1733001,1601766,1473689,80241,4834,112,03/04/2021
46579,66209,19630,0,Jharkhand,431,65778,66209,208644,66209,2190,327,0,04/02/2021
149757,323632,173869,44761,Jharkhand,32738,290894,368393,421330,323632,12792,696,6,04/03/2021
783168,1578359,795067,261144,Jharkhand,191267,1648236,1839503,1578359,1578359,193470,1659,124,04/04/2021
53599,77034,23435,0,Jharkhand,620,76414,77034,217792,77034,2493,355,0,05/02/2021
155135,336342,181201,53101,Jharkhand,34287,302055,389443,433838,336342,13811,725,6,05/03/2021
819465,1649049,829452,264591,Jharkhand,192540,1721100,1913640,1649049,1649049,221800,1926,132,05/04/2021
58961,86786,27825,0,Jharkhand,832,85954,86786,230512,86786,2827,380,0,06/02/2021
160605,349329,188718,60890,Jharkhand,35706,313623,410219,446115,349329,14845,756,6,06/03/2021
848407,1705435,856890,267846,Jharkhand,193574,1779707,1973281,1705435,1705435,127750,1148,138,06/04/2021
64321,96697,32376,0,Jharkhand,1024,95673,96697,240827,96697,3123,400,0,07/02/2021
162476,353354,190871,63433,Jharkhand,36088,317266,416787,450216,353354,15782,771,7,07/03/2021
889385,1788075,898543,274683,Jharkhand,196170,1866588,2062758,1788075,1788075,226100,2000,147,07/04/2021
72326,113951,41625,0,Jharkhand,1559,112392,113951,253625,113951,3473,432,0,08/02/2021
169335,368526,199183,74228,Jharkhand,37255,331271,442754,465356,368526,16553,791,8,08/03/2021
922535,1855020,932330,279807,Jharkhand,198353,1936474,2134827,1855020,1855020,197400,1788,155,08/04/2021
80965,133247,52282,0,Jharkhand,2127,131120,133247,268884,133247,3826,455,0,09/02/2021
175967,383287,207311,89001,Jharkhand,38365,344922,472288,479682,383287,17781,812,9,09/03/2021
933996,1879293,945139,283324,Jharkhand,202123,1960494,2162617,1879293,1879293,137050,1221,158,09/04/2021
89401,152985,63584,0,Jharkhand,2587,150398,152985,283424,152985,4205,468,0,10/02/2021
184101,401766,217656,105387,Jharkhand,39340,362426,507153,497440,401766,18935,884,9,10/03/2021
980141,1970433,990122,289690,Jharkhand,206072,2054051,2260123,1970433,1970433,243290,2194,170,10/04/2021
95331,167957,72626,0,Jharkhand,2940,165017,167957,294249,167957,4537,481,0,11/02/2021
188416,412082,223656,111897,Jharkhand,39753,372329,523979,507452,412082,20701,981,10,11/03/2021
1028092,2065113,1036840,294571,Jharkhand,208265,2151419,2359684,2065113,2065113,257850,2322,181,11/04/2021
100761,181722,80961,0,Jharkhand,3478,178244,181722,306907,181722,4916,496,0,12/02/2021
198090,433229,235126,126790,Jharkhand,40380,392849,560019,528351,433229,23804,1021,13,12/03/2021
1056672,2127045,1070180,302111,Jharkhand,210623,2218533,2429156,2127045,2127045,184150,1640,193,12/04/2021
106394,195956,89562,1978,Jharkhand,4117,191839,197934,320156,195956,5320,502,0,13/02/2021
205612,450753,245128,139248,Jharkhand,41020,409733,590001,545543,450753,25857,1139,13,13/03/2021
1088922,2196926,1107805,308781,Jharkhand,212617,2293090,2505707,2196926,2196926,260301,2304,199,13/04/2021
109273,203227,93954,2197,Jharkhand,4439,198788,205424,333314,203227,5627,507,0,14/02/2021
212339,464929,252576,145718,Jharkhand,41344,423585,610647,559065,464929,29514,1204,14,14/03/2021
1129470,2279843,1150162,315875,Jharkhand,214501,2381217,2595718,2279843,2279843,253700,2286,211,14/04/2021
114197,215731,101534,4142,Jharkhand,5480,210251,219873,349255,215731,6004,509,0,15/02/2021
225810,493667,267841,160178,Jharkhand,42279,451388,653845,588590,493667,34065,1277,16,15/03/2021
1146520,2318245,1171510,322527,Jharkhand,216038,2424734,2640772,2318245,2318245,175650,1614,215,15/04/2021
233,344,111,0,Jharkhand,0,344,344,120093,344,60,53,0,16/01/2021
117115,222983,105867,5575,Jharkhand,6506,216477,228558,364892,222983,6330,515,1,16/02/2021
240425,524054,283612,172451,Jharkhand,43673,480381,696505,618647,524054,36658,1314,17,16/03/2021
1160415,2351517,1190884,330232,Jharkhand,217591,2464158,2681749,2351517,2351517,283920,2408,218,16/04/2021
233,344,111,0,Jharkhand,0,344,344,120363,344,136,62,0,17/01/2021
121356,233318,111961,7692,Jharkhand,7854,225464,241010,386974,233318,6670,517,1,17/02/2021
254698,553533,298813,182894,Jharkhand,44927,508606,736427,647560,553533,39178,1526,22,17/03/2021
1179366,2393775,1214184,339689,Jharkhand,218889,2514575,2733464,2393775,2393775,305600,2662,225,17/04/2021
541,749,208,0,Jharkhand,0,749,749,121128,749,263,66,0,18/01/2021
122879,240361,117479,8686,Jharkhand,9959,230402,249047,372887,240361,6994,519,3,18/02/2021
265293,576960,311643,192254,Jharkhand,46310,530650,769214,671325,576960,41934,1922,24,18/03/2021
1195094,2427024,1231702,348238,Jharkhand,220573,2554689,2775262,2427024,2427024,223350,2077,228,18/04/2021
1037,1455,418,0,Jharkhand,0,1455,1455,126394,1455,369,68,0,19/01/2021
127488,251913,124422,10774,Jharkhand,11807,240106,262687,407767,251913,7346,523,3,19/02/2021
277557,602708,325121,200194,Jharkhand,47793,554915,802902,698835,602708,47351,2920,30,19/03/2021
1204150,2449014,1244634,358529,Jharkhand,222787,2584756,2807543,2449014,2449014,291000,2518,230,19/04/2021
1661,2258,597,0,Jharkhand,0,2258,2258,130666,2258,412,69,0,20/01/2021
129953,259546,129590,11583,Jharkhand,14679,244867,271129,414261,259546,7678,524,3,20/02/2021
327968,700736,372731,208349,Jharkhand,54332,646404,909085,812855,700736,50045,3191,37,20/03/2021
1216395,2477515,1260887,371204,Jharkhand,227604,2621115,2848719,2477515,2477515,326351,2839,233,20/04/2021
1661,2258,597,0,Jharkhand,0,2258,2258,133416,2258,469,73,0,21/01/2021
130395,261700,131302,11766,Jharkhand,15441,246259,273466,414763,261700,7866,524,3,21/02/2021
413217,860701,447427,212369,Jharkhand,62148,798553,1073070,969269,860701,51795,3394,57,21/03/2021
1224689,2496708,1271782,380745,Jharkhand,231690,2645763,2877453,2496708,2496708,226370,2052,237,21/04/2021
3025,4023,998,0,Jharkhand,0,4023,4023,145989,4023,493,77,0,22/01/2021
132064,268315,136248,13661,Jharkhand,18051,250264,281976,415693,268315,8216,539,3,22/02/2021
432061,897803,465682,218663,Jharkhand,64323,833480,1116466,1008167,897803,55418,3772,60,22/03/2021
1230623,2512136,1281274,389739,Jharkhand,235917,2665958,2901875,2512136,2512136,252950,2247,239,22/04/2021
3087,4117,1030,0,Jharkhand,0,4117,4117,152030,4117,586,96,0,23/01/2021
133367,274560,141190,14813,Jharkhand,20338,254222,289373,415813,274560,8532,552,3,23/02/2021
509467,1044024,534484,226839,Jharkhand,80166,963858,1270863,1159880,1044024,57871,4007,73,23/03/2021
1239087,2532881,1293553,402484,Jharkhand,242888,2692477,2935365,2532881,2532881,310601,2656,241,23/04/2021
3428,4573,1145,0,Jharkhand,0,4573,4573,165438,4573,644,108,0,24/01/2021
134556,279979,145419,18048,Jharkhand,22602,257377,298027,415882,279979,8842,558,4,24/02/2021
569988,1158510,588434,231964,Jharkhand,98851,1059659,1390474,1276232,1158510,59418,4116,88,24/03/2021
1246566,2550782,1303973,414239,Jharkhand,251321,2713700,2965021,2550782,2550782,188800,1688,243,24/04/2021
6465,8636,2171,0,Jharkhand,0,8636,8636,172744,8636,679,120,0,25/01/2021
135569,285072,149499,19237,Jharkhand,24941,260131,304309,416022,285072,9168,563,4,25/02/2021
588679,1195205,606435,236026,Jharkhand,106866,1088339,1431231,1311038,1195205,62592,4380,91,25/03/2021
1249778,2558670,1308648,419195,Jharkhand,255987,2721878,2977865,2558670,2558670,113300,1039,244,25/04/2021
6524,8708,2184,0,Jharkhand,0,8708,8708,174441,8708,715,130,0,26/01/2021
136554,289681,153123,23757,Jharkhand,27397,262284,313438,390764,289681,9256,566,4,26/02/2021
619695,1253464,633671,239336,Jharkhand,141125,1112339,1492800,1372738,1253464,66180,4576,98,26/03/2021
1256616,2574711,1317847,430606,Jharkhand,266107,2739210,3005317,2574711,2574711,193750,1739,248,26/04/2021
11267,15269,4002,0,Jharkhand,0,15269,15269,178389,15269,812,160,0,27/01/2021
136554,289681,153123,23757,Jharkhand,27397,262284,313438,390770,289681,9256,566,4,27/02/2021
671355,1349874,678414,242106,Jharkhand,155622,1194252,1591980,1472047,1349874,68232,4660,105,27/03/2021
1262405,2589148,1326494,439976,Jharkhand,275310,2753814,3029124,2589148,2589148,199500,1810,249,27/04/2021
11441,15617,4176,0,Jharkhand,0,15617,15617,179927,15617,988,218,0,28/01/2021
678948,1363659,684606,242239,Jharkhand,156941,1206718,1605898,1484131,1363659,68919,4666,105,28/03/2021
17383,23685,6302,0,Jharkhand,0,23685,23685,184625,23685,1119,232,0,29/01/2021
679794,1365197,685298,242336,Jharkhand,157063,1208134,1607533,1485706,1365197,69132,4666,105,29/03/2021
22995,31477,8482,0,Jharkhand,0,31477,31477,189296,31477,1204,241,0,30/01/2021
683810,1373583,689668,244528,Jharkhand,158737,1214846,1618111,1494231,1373583,70535,4678,105,30/03/2021
23075,31672,8597,0,Jharkhand,0,31672,31672,190358,31672,1390,252,0,31/01/2021
693325,1393056,699625,248528,Jharkhand,160416,1232640,1641584,1514219,1393056,72421,4722,106,31/03/2021
168980,249931,80913,0,Karnataka,3237,246694,249931,593550,249931,9098,4408,38,01/02/2021
1779332,3353407,1573731,466835,Karnataka,404939,2948468,3820242,3705712,3353407,242387,9326,344,01/04/2021
169465,250715,81212,0,Karnataka,3237,247478,250715,594989,250715,9273,4455,38,02/02/2021
342014,621289,279192,224437,Karnataka,6415,614874,845726,928587,621289,32414,5990,83,02/03/2021
1870761,3523151,1652026,471942,Karnataka,418711,3104440,3995093,3877221,3523151,257220,9862,364,02/04/2021
170050,251723,81635,0,Karnataka,3237,248486,251723,595853,251723,9830,4554,38,03/02/2021
346903,633181,286197,227236,Karnataka,6447,626734,860417,940607,633181,33347,6002,81,03/03/2021
1960097,3688952,1728472,477129,Karnataka,429129,3259823,4166081,4059640,3688952,269363,10190,383,03/04/2021
178974,265577,86565,0,Karnataka,3347,262230,265577,611156,265577,10732,4689,38,04/02/2021
352160,645171,292928,230426,Karnataka,6498,638673,875597,953059,645171,34949,6019,83,04/03/2021
2172207,4108669,1936005,483676,Karnataka,464461,4127884,4592345,4108669,4108669,510310,4510,457,04/04/2021
199636,295307,95612,0,Karnataka,3611,291696,295307,648142,295307,11583,4794,59,05/02/2021
359425,661097,301588,236171,Karnataka,6536,654561,897268,969157,661097,41281,6039,84,05/03/2021
2263714,4274168,2009976,490923,Karnataka,478207,4286884,4765091,4274168,4274168,675771,6103,478,05/04/2021
217707,321521,103745,0,Karnataka,3960,317561,321521,695453,321521,12094,4900,69,06/02/2021
367813,678604,310707,244803,Karnataka,6561,672043,923407,986718,678604,56159,6132,84,06/03/2021
2320752,4378738,2057498,495705,Karnataka,491658,4382785,4874443,4378738,4378738,705350,6304,488,06/04/2021
219837,325554,105648,0,Karnataka,4641,320913,325554,705105,325554,12737,5064,69,07/02/2021
368647,680182,311451,245649,Karnataka,6560,673622,925831,988322,680182,65298,6200,84,07/03/2021
2487150,4681696,2194018,511393,Karnataka,522784,4670305,5193089,4681696,4681696,743223,6734,528,07/04/2021
228283,350327,121975,0,Karnataka,4714,345613,350327,736349,350327,13474,5173,69,08/02/2021
393159,729461,336214,264921,Karnataka,6613,722848,994382,1038760,729461,68505,6238,88,08/03/2021
2625464,4936256,2310232,526914,Karnataka,541190,4921980,5463170,4936256,4936256,739551,6527,560,08/04/2021
236937,379152,142146,0,Karnataka,4754,374398,379152,775151,379152,14071,5259,69,09/02/2021
411237,767080,355748,277403,Karnataka,6738,760342,1044483,1076660,767080,78945,6266,95,09/03/2021
2788693,5241266,2451971,546963,Karnataka,555182,5233047,5788229,5241266,5241266,817850,7338,602,09/04/2021
242606,403105,160426,0,Karnataka,4760,398345,403105,799782,403105,14562,5326,73,10/02/2021
448962,844107,395038,298099,Karnataka,6792,837315,1142206,1154593,844107,103172,6321,107,10/03/2021
2926258,5502062,2575155,564395,Karnataka,566845,5499612,6066457,5502062,5502062,752250,6838,649,10/04/2021
245579,415241,169589,0,Karnataka,4772,410469,415241,824642,415241,15207,5443,73,11/02/2021
455760,857731,401863,301913,Karnataka,6794,850937,1159644,1168152,857731,115199,6358,108,11/03/2021
2995283,5635988,2640037,572552,Karnataka,572077,5636463,6208540,5635988,5635988,692240,6163,668,11/04/2021
250572,430303,179657,0,Karnataka,4782,425521,430303,861599,430303,15543,5492,74,12/02/2021
500328,949585,449140,318572,Karnataka,6876,942709,1268157,1261264,949585,125035,6447,117,12/03/2021
3084145,5814005,2729159,593146,Karnataka,578395,5828756,6407151,5814005,5814005,779510,6980,701,12/04/2021
252500,435670,183096,15,Karnataka,4782,430888,435685,888365,435670,15719,5547,74,13/02/2021
522871,995126,472136,325797,Karnataka,6998,988128,1320923,1307283,995126,129629,6493,119,13/03/2021
3100011,5848181,2747459,598268,Karnataka,580152,5866297,6446449,5848181,5848181,679710,6051,711,13/04/2021
252526,435820,183220,15,Karnataka,4782,431038,435835,890485,435820,16274,5560,74,14/02/2021
532419,1013688,481148,326840,Karnataka,7024,1006664,1340528,1325977,1013688,133481,6564,121,14/03/2021
3145397,5935191,2789071,615187,Karnataka,585978,5964400,6550378,5935191,5935191,702910,6246,723,14/04/2021
261104,451537,190356,11301,Karnataka,5059,446478,462838,916894,451537,17101,5594,77,15/02/2021
612548,1171133,558454,340253,Karnataka,8441,1162692,1511386,1487452,1171133,137542,6599,131,15/03/2021
3212623,6060959,2847597,643343,Karnataka,595970,6108332,6704302,6060959,6060959,713610,6219,739,15/04/2021
1975,3810,1835,0,Karnataka,78,3732,3810,369283,3810,256,235,0,16/01/2021
275768,473092,197243,28526,Karnataka,5293,467799,501618,946010,473092,18099,5614,81,16/02/2021
663839,1273399,609421,350948,Karnataka,11618,1261781,1624347,1589597,1273399,139918,6633,139,16/03/2021
3299828,6226534,2925945,683677,Karnataka,613354,6296857,6910211,6226534,6226534,753660,6538,761,16/04/2021
2133,4506,2373,0,Karnataka,82,4424,4506,369853,4506,1385,1139,0,17/01/2021
299633,505305,205586,54739,Karnataka,5607,499698,560044,983100,505305,18868,5644,86,17/02/2021
779977,1493510,713374,364581,Karnataka,16165,1477345,1858091,1812841,1493510,142942,6674,159,17/03/2021
3417138,6449119,3031185,742766,Karnataka,642055,6549830,7191885,6449119,6449119,740050,6682,796,17/04/2021
8633,14755,6122,0,Karnataka,299,14456,14755,366934,14755,1999,1502,0,18/01/2021
268504,472428,203839,65249,Karnataka,5433,466995,537677,930404,472428,19974,5673,85,18/02/2021
831054,1592296,761073,373211,Karnataka,23004,1569292,1965507,1912226,1592296,145476,6700,169,18/03/2021
3459851,6532361,3071706,764180,Karnataka,654574,6641967,7296541,6532361,6532361,707510,6265,804,18/04/2021
14649,25142,10492,0,Karnataka,443,24699,25142,375336,25142,2788,1993,1,19/01/2021
312875,535611,222648,101757,Karnataka,5833,529778,637368,1019661,535611,20768,5706,88,19/02/2021
950079,1815249,864983,384826,Karnataka,34690,1780559,2200075,2146883,1815249,149448,6820,187,19/03/2021
3552673,6710926,3157425,831814,Karnataka,688768,6853972,7542740,6710926,6710926,810010,7256,828,19/04/2021
23283,36705,13421,0,Karnataka,547,36158,36705,386786,36705,3687,2517,1,20/01/2021
316691,546779,230000,117081,Karnataka,5873,540906,663860,1022011,546779,21643,5735,88,20/02/2021
1047401,1998992,951389,396521,Karnataka,60038,1938954,2395513,2329242,1998992,153275,6898,202,20/03/2021
3634252,6871164,3236053,897177,Karnataka,723260,7045081,7768341,6871164,6871164,829600,7385,859,20/04/2021
29669,47344,17664,0,Karnataka,670,46674,47344,396798,47344,4761,3098,11,21/01/2021
316962,547587,230535,117993,Karnataka,5873,541714,665580,1022262,547587,25428,5842,90,21/02/2021
1063097,2028568,965264,397934,Karnataka,64900,1963668,2426502,2353810,2028568,156343,6987,207,21/03/2021
3701769,7004724,3302074,952974,Karnataka,753927,7203771,7957698,7004724,7004724,774590,6960,881,21/04/2021
51065,77432,26356,0,Karnataka,818,76614,77432,421066,77432,5156,3252,11,22/01/2021
321671,560544,238783,144539,Karnataka,5965,554579,705083,1023384,560544,27219,5866,90,22/02/2021
1160244,2207182,1046710,407034,Karnataka,103604,2103578,2614216,2550606,2207182,159698,7168,228,22/03/2021
3779537,7158532,3378086,1030733,Karnataka,788176,7401089,8189265,7158532,7158532,802100,7148,909,22/04/2021
55626,84585,28948,0,Karnataka,842,83743,84585,455168,84585,5591,3435,11,23/01/2021
326853,575708,248773,163084,Karnataka,6079,569629,738792,1024020,575708,27768,5878,82,23/02/2021
1231624,2340530,1108666,416031,Karnataka,153609,2186921,2756561,2670263,2340530,164973,7355,240,23/03/2021
3864056,7334071,3469082,1112213,Karnataka,829495,7616789,8446284,7334071,7334071,826360,7407,933,23/04/2021
62056,93426,31342,0,Karnataka,889,92537,93426,463280,93426,6385,3748,28,24/01/2021
1322700,2509495,1186537,424897,Karnataka,216427,2293068,2934392,2841243,2509495,169246,7477,258,24/03/2021
3911703,7439115,3526465,1153723,Karnataka,854160,7738678,8592838,7439115,7439115,700250,6474,947,24/04/2021
94811,138721,43880,0,Karnataka,1186,137535,138721,494804,138721,6782,3884,30,25/01/2021
335637,601961,266242,200140,Karnataka,6321,595640,802101,1026719,601961,30150,5908,82,25/02/2021
1367585,2594009,1226160,429561,Karnataka,259491,2334518,3023570,2926815,2594009,172209,7555,264,25/03/2021
3937819,7495232,3556456,1178314,Karnataka,861190,7812356,8673546,7495232,7495232,705670,6449,957,25/04/2021
96582,140856,44244,0,Karnataka,1407,139449,140856,500094,140856,7473,4122,30,26/01/2021
338283,611335,272970,221690,Karnataka,6374,604961,833025,918743,611335,30377,5911,82,26/02/2021
1447096,2742455,1295085,437153,Karnataka,310426,2432029,3179608,3079674,2742455,176212,7621,274,26/03/2021
4003824,7631765,3626966,1260334,Karnataka,882421,8009678,8892099,7631765,7631765,763690,6974,975,26/04/2021
136401,196089,59653,0,Karnataka,2208,193881,196089,526515,196089,8018,4235,35,27/01/2021
1507282,2855072,1347501,442710,Karnataka,339175,2515897,3297782,3191358,2855072,179088,7669,289,27/03/2021
4061863,7750770,3687912,1337230,Karnataka,896837,8191163,9088000,7750770,7750770,782540,7108,995,27/04/2021
148457,215875,67383,0,Karnataka,2738,213137,215875,548305,215875,8574,4347,35,28/01/2021
1516848,2873457,1356317,443224,Karnataka,341706,2531751,3316681,3208981,2873457,183138,7737,292,28/03/2021
160102,234619,74482,0,Karnataka,2912,231707,234619,566548,234619,8839,4371,35,29/01/2021
1587351,3001113,1413461,449073,Karnataka,361832,2639281,3450186,3338633,3001113,190695,7816,301,29/03/2021
166730,246438,79670,0,Karnataka,3230,243208,246438,583876,246438,8951,4391,38,30/01/2021
1646644,3109136,1462176,454928,Karnataka,378111,2731025,3564064,3448373,3109136,205423,7969,316,30/03/2021
167527,247613,80048,0,Karnataka,3237,244376,247613,586666,247613,9027,4393,38,31/01/2021
1721764,3246599,1524502,462573,Karnataka,393729,2852870,3709172,3587596,3246599,223996,8605,333,31/03/2021
129791,173482,43684,0,Kerala,0,173482,173482,372219,173482,3562,759,7,01/02/2021
1238104,2199560,961306,406287,Kerala,80260,2119300,2605847,2595229,2199560,83783,2934,150,01/04/2021
153398,204449,51042,0,Kerala,0,204449,204449,387624,204449,3948,789,9,02/02/2021
339100,534490,195372,118709,Kerala,62855,471635,653199,1043254,534490,15275,1603,18,02/03/2021
1257020,2233136,975963,408622,Kerala,80537,2152599,2641758,2627789,2233136,85169,2953,153,02/04/2021
169554,225664,56100,0,Kerala,0,225664,225664,401801,225664,4462,827,10,03/02/2021
354203,564199,209978,127659,Kerala,63138,501061,691858,1061461,564199,18076,1713,18,03/03/2021
1294558,2296271,1001558,414020,Kerala,80725,2215546,2710291,2701499,2296271,87025,2972,155,03/04/2021
188949,250831,61871,0,Kerala,0,250831,250831,420049,250831,4740,837,11,04/02/2021
386981,627900,240900,147038,Kerala,63956,563944,774938,1103170,627900,20736,1799,19,04/03/2021
1888134,3463563,1575071,424768,Kerala,143892,3744439,3888331,3463563,3463563,66010,458,358,04/04/2021
200452,266068,65605,0,Kerala,0,266068,266068,435068,266068,4860,841,11,05/02/2021
419345,689867,270499,166330,Kerala,64566,625301,856197,1145674,689867,23620,1892,23,05/03/2021
1952832,3573568,1620368,431649,Kerala,144425,3860792,4005217,3573568,3573568,218935,1570,368,05/04/2021
204679,271731,67041,0,Kerala,0,271731,271731,456322,271731,4960,866,11,06/02/2021
454518,756016,301470,187155,Kerala,64997,691019,943171,1192420,756016,25728,1925,28,06/03/2021
1972554,3608126,1635201,434218,Kerala,144684,3897660,4042344,3608126,3608126,93940,713,371,06/04/2021
205025,272221,67185,0,Kerala,0,272221,272221,471671,272221,5197,883,11,07/02/2021
460702,767969,307239,188358,Kerala,64997,702972,956327,1200020,767969,26700,1943,28,07/03/2021
2024554,3698854,1673913,441833,Kerala,145437,3995250,4140687,3698854,3698854,201340,1308,387,07/04/2021
216521,287787,71255,0,Kerala,0,287787,287787,499729,287787,5418,893,11,08/02/2021
491853,829751,337866,209019,Kerala,65335,764416,1038770,1250610,829751,30151,1987,32,08/03/2021
2141438,3899533,1757681,457415,Kerala,146408,4210540,4356948,3899533,3899533,259252,1692,414,08/04/2021
227379,302655,75265,0,Kerala,1,302654,302655,518828,302655,5579,898,11,09/02/2021
518483,882614,364094,227996,Kerala,65913,816701,1110610,1296060,882614,31450,2001,37,09/03/2021
2256641,4099009,1841931,476570,Kerala,147850,4427729,4575579,4099009,4099009,262105,1730,437,09/04/2021
230319,306802,76472,0,Kerala,1,306801,306802,529963,306802,5763,929,11,10/02/2021
532462,908813,376311,240021,Kerala,65993,842820,1148834,1319705,908813,35572,2068,40,10/03/2021
2355073,4270854,1915320,492896,Kerala,149328,4614422,4763750,4270854,4270854,224225,1520,461,10/04/2021
233370,314425,81044,0,Kerala,563,313862,314425,537996,314425,6174,1022,11,11/02/2021
548037,937804,389724,249459,Kerala,66140,871664,1187263,1346021,937804,37342,2122,43,11/03/2021
2388985,4333798,1944347,496868,Kerala,149990,4680676,4830666,4333798,4333798,134861,867,466,11/04/2021
236353,326974,90610,0,Kerala,8514,318460,326974,549240,326974,6538,1053,11,12/02/2021
583415,1004716,421252,269548,Kerala,66737,937979,1274264,1408973,1004716,40224,2152,49,12/03/2021
2525926,4571524,2045082,526491,Kerala,152985,4945030,5098015,4571524,4571524,290180,1822,516,12/04/2021
238841,338167,99315,0,Kerala,18256,319911,338167,560660,338167,6720,1057,11,13/02/2021
603811,1042086,438226,279614,Kerala,67645,974441,1321700,1444442,1042086,42355,2185,49,13/03/2021
2604323,4714085,2109225,553088,Kerala,156460,5110713,5267173,4714085,4714085,271852,1736,537,13/04/2021
239420,340407,100976,45,Kerala,20439,319968,340452,562895,340407,6953,1061,11,14/02/2021
605735,1045645,439861,280408,Kerala,67646,977999,1326053,1447841,1045645,43888,2222,49,14/03/2021
2612419,4730173,2117216,557313,Kerala,157699,5129787,5287486,4730173,4730173,118910,900,538,14/04/2021
244832,353940,109097,3323,Kerala,28363,325577,357263,575339,353940,7275,1065,11,15/02/2021
642691,1115552,472803,296711,Kerala,68602,1046950,1412263,1515240,1115552,46723,2288,58,15/03/2021
2705623,4899502,2193316,597051,Kerala,172708,5323845,5496553,4899502,4899502,245990,1658,563,15/04/2021
1088,1681,593,0,Kerala,0,1681,1681,292366,1681,147,134,0,16/01/2021
253413,370481,117056,12148,Kerala,33717,336764,382629,587393,370481,7495,1065,12,16/02/2021
681142,1187342,506136,311430,Kerala,69561,1117781,1498772,1583900,1187342,49656,2338,64,16/03/2021
2782737,5040807,2257490,639307,Kerala,199162,5480952,5680114,5040807,5040807,217590,1531,580,16/04/2021
1193,1836,643,0,Kerala,0,1836,1836,293075,1836,317,156,0,17/01/2021
256961,377376,120403,15388,Kerala,36217,341159,392764,603459,377376,7778,1067,12,17/02/2021
699253,1221340,522022,320299,Kerala,70018,1151322,1541639,1616824,1221340,52971,2374,65,17/03/2021
2845392,5158591,2312598,673957,Kerala,240926,5591622,5832548,5158591,5158591,154580,1165,601,17/04/2021
1820,2566,746,0,Kerala,0,2566,2566,292909,2566,488,180,0,18/01/2021
254442,377981,123526,23336,Kerala,42079,335902,401317,597345,377981,8065,1067,13,18/02/2021
739312,1296378,556996,332307,Kerala,70968,1225410,1628685,1689779,1296378,55958,2411,70,18/03/2021
2860281,5189796,2328909,680436,Kerala,255745,5614487,5870232,5189796,5189796,122710,880,606,18/04/2021
3826,5355,1529,0,Kerala,0,5355,5355,297898,5355,544,185,0,19/01/2021
269285,400463,131165,32101,Kerala,47318,353145,432564,623481,400463,8370,1080,13,19/02/2021
776754,1365098,588267,341960,Kerala,71643,1293455,1707058,1758694,1365098,58439,2477,77,19/03/2021
2917173,5299053,2381261,727279,Kerala,288756,5737576,6026332,5299053,5299053,203991,1441,619,19/04/2021
3846,5398,1552,0,Kerala,0,5398,5398,298428,5398,716,216,0,20/01/2021
272085,406728,134630,38833,Kerala,52144,354584,445561,689231,406728,8533,1090,13,20/02/2021
814142,1432902,618681,350588,Kerala,72688,1360214,1783490,1824612,1432902,60499,2508,79,20/03/2021
2993054,5443386,2449699,800229,Kerala,312000,5931615,6243615,5443386,5443386,192246,1429,633,20/04/2021
6618,9175,2557,0,Kerala,0,9175,9175,304200,9175,883,236,0,21/01/2021
272244,407098,134841,38841,Kerala,52355,354743,445939,808701,407098,8724,1109,13,21/02/2021
816646,1437604,620878,351252,Kerala,72759,1364845,1788856,1828272,1437604,62255,2601,80,21/03/2021
3028625,5512304,2483037,841296,Kerala,322945,6030655,6353600,5512304,5512304,170365,1213,642,21/04/2021
11321,15501,4180,0,Kerala,0,15501,15501,308583,15501,1003,259,0,22/01/2021
275217,413599,138369,56034,Kerala,57459,356140,469633,922971,413599,9064,1132,13,22/02/2021
861351,1520242,658805,358497,Kerala,73743,1446499,1878739,1915795,1520242,65236,2682,86,22/03/2021
3076458,5602945,2525828,900089,Kerala,333703,6169331,6503034,5602945,5602945,172874,1301,659,22/04/2021
16229,21944,5715,0,Kerala,0,21944,21944,313559,21944,1165,308,0,23/01/2021
279543,422676,143120,62077,Kerala,60036,362640,484753,954097,422676,9413,1149,13,23/02/2021
908652,1607463,698716,371524,Kerala,75319,1532144,1978987,1997970,1607463,67513,2708,95,23/03/2021
3113525,5673943,2559741,954445,Kerala,339373,6289015,6628388,5673943,5673943,172728,1247,677,23/04/2021
17288,23324,6036,0,Kerala,0,23324,23324,314892,23324,1252,333,0,24/01/2021
283634,431070,147423,70173,Kerala,60822,370248,501243,979890,431070,10099,1290,13,24/02/2021
931715,1650371,718555,375508,Kerala,75784,1574587,2025879,2040995,1650371,69402,2747,101,24/03/2021
3172415,5788568,2615457,1039187,Kerala,343411,6484344,6827755,5788568,5788568,205317,1310,696,24/04/2021
32347,43561,11213,0,Kerala,0,43561,43561,322973,43561,1302,347,1,25/01/2021
293702,449826,156111,88541,Kerala,61483,388343,538367,1015697,449826,10996,1408,13,25/02/2021
982504,1744033,761422,381311,Kerala,76745,1667288,2125344,2135201,1744033,71299,2780,107,25/03/2021
3178777,5801281,2621806,1045794,Kerala,344350,6502725,6847075,5801281,5801281,80837,597,698,25/04/2021
32496,43766,11269,0,Kerala,0,43766,43766,324617,43766,1462,374,1,26/01/2021
315577,489113,173522,104220,Kerala,62561,426552,593333,1018799,489113,11310,1445,14,26/02/2021
1026609,1823895,797170,385701,Kerala,77418,1746477,2209596,2215200,1823895,72973,2807,116,26/03/2021
3222372,5885170,2662083,1105948,Kerala,349708,6641410,6991118,5885170,5885170,180172,1325,715,26/04/2021
43030,58323,15292,0,Kerala,0,58323,58323,329559,58323,1792,416,1,27/01/2021
1068552,1899978,831303,389543,Kerala,78081,1821897,2289521,2291657,1899978,75496,2843,123,27/03/2021
3254720,5947361,2691909,1159581,Kerala,352774,6754168,7106942,5947361,5947361,146869,1075,732,27/04/2021
61477,82794,21316,0,Kerala,0,82794,82794,337105,82794,2140,535,1,28/01/2021
315577,489113,173522,104220,Kerala,62561,426552,593333,1018800,489113,11510,1448,14,28/02/2021
1072420,1907129,834586,389710,Kerala,78082,1829047,2296839,2298496,1907129,76652,2861,123,28/03/2021
82814,110719,27902,0,Kerala,0,110719,110719,346576,110719,2435,588,3,29/01/2021
1129061,2007746,878546,394099,Kerala,78787,1928959,2401845,2400587,2007746,78437,2878,139,29/03/2021
100409,134225,33810,0,Kerala,0,134225,134225,358394,134225,2772,647,6,30/01/2021
1186837,2109626,922644,400171,Kerala,79507,2030119,2509797,2503222,2109626,80507,2896,145,30/03/2021
105412,140906,35488,0,Kerala,0,140906,140906,361092,140906,3136,712,6,31/01/2021
1211279,2152599,941173,403735,Kerala,80053,2072546,2556334,2545534,2152599,82234,2921,147,31/03/2021
686,1065,379,0,Ladakh,0,1065,1065,13423,1065,25,16,0,01/02/2021
19356,43563,24204,6870,Ladakh,50,43513,50433,46337,43563,1117,183,3,01/04/2021
3292,9990,6698,1140,Ladakh,39,9951,11130,13319,9990,238,75,0,02/03/2021
21945,48598,26650,6923,Ladakh,50,48548,55521,51569,48598,1197,186,3,02/04/2021
890,1342,452,0,Ladakh,0,1342,1342,13510,1342,36,18,0,03/02/2021
3608,10778,7170,1427,Ladakh,40,10738,12205,13949,10778,276,75,0,03/03/2021
23810,52281,28468,6981,Ladakh,50,52231,59262,55457,52281,1247,188,3,03/04/2021
890,1342,452,0,Ladakh,0,1342,1342,13517,1342,42,20,0,04/02/2021
3890,11538,7648,1510,Ladakh,40,11498,13048,14671,11538,323,75,0,04/03/2021
25225,55578,30350,6636,Ladakh,0,62214,62214,55578,55578,5600,39,3,04/04/2021
1058,1578,520,0,Ladakh,0,1578,1578,13692,1578,43,20,0,05/02/2021
4268,12393,8125,1746,Ladakh,41,12352,14139,15614,12393,376,77,0,05/03/2021
26622,58417,31792,6672,Ladakh,0,65089,65089,58417,58417,6600,45,3,05/04/2021
1244,1817,573,0,Ladakh,0,1817,1817,13788,1817,47,22,0,06/02/2021
5060,14387,9327,1978,Ladakh,41,14346,16365,17367,14387,406,79,0,06/03/2021
27318,59863,32542,6750,Ladakh,0,66613,66613,59863,59863,6400,44,3,06/04/2021
28466,62372,33902,7019,Ladakh,0,69391,69391,62372,62372,6000,41,4,07/04/2021
1427,2064,637,0,Ladakh,2,2062,2064,13887,2064,59,29,0,08/02/2021
6231,16882,10651,2214,Ladakh,41,16841,19096,19891,16882,447,88,0,08/03/2021
29237,63903,34662,7356,Ladakh,0,71259,71259,63903,63903,3400,24,4,08/04/2021
1477,2158,681,0,Ladakh,22,2136,2158,13981,2158,60,30,0,09/02/2021
7633,19753,12120,2299,Ladakh,43,19710,22052,22811,19753,486,91,0,09/03/2021
29398,64284,34882,7676,Ladakh,0,71960,71960,64284,64284,6200,44,4,09/04/2021
1640,2379,739,0,Ladakh,22,2357,2379,14114,2379,66,33,0,10/02/2021
9084,22712,13626,2505,Ladakh,45,22667,25217,25707,22712,536,99,2,10/03/2021
29500,64518,35014,7913,Ladakh,0,72431,72431,64518,64518,2400,18,4,10/04/2021
1829,2597,768,0,Ladakh,23,2574,2597,14353,2597,66,33,0,11/02/2021
10616,25620,15002,2719,Ladakh,47,25573,28339,28615,25620,570,106,2,11/03/2021
29798,65236,35434,8161,Ladakh,0,73397,73397,65236,65236,7800,55,4,11/04/2021
1913,2695,782,0,Ladakh,23,2672,2695,14430,2695,69,33,0,12/02/2021
11967,28201,16232,2812,Ladakh,47,28154,31013,31218,28201,618,118,2,12/03/2021
30204,66115,35907,8493,Ladakh,0,74608,74608,66115,66115,7300,49,4,12/04/2021
2028,2831,803,71,Ladakh,23,2808,2902,14475,2831,71,34,0,13/02/2021
13146,30737,17588,2904,Ladakh,47,30690,33641,33702,30737,661,127,3,13/03/2021
30402,66540,36134,8779,Ladakh,0,75319,75319,66540,66540,5900,39,4,13/04/2021
13422,31307,17882,2906,Ladakh,47,31260,34213,34273,31307,669,128,3,14/03/2021
30529,66813,36280,9092,Ladakh,0,75905,75905,66813,66813,3400,23,4,14/04/2021
14608,33594,18983,2930,Ladakh,47,33547,36524,36667,33594,728,147,3,15/03/2021
30566,66918,36347,9552,Ladakh,0,76470,76470,66918,66918,3800,24,5,15/04/2021
9,9,0,0,Ladakh,0,9,9,9378,9,1,1,0,16/01/2021
2188,3433,1245,169,Ladakh,23,3410,3602,14597,3433,91,39,0,16/02/2021
15270,35036,19763,3367,Ladakh,47,34989,38403,38086,35036,779,157,3,16/03/2021
30595,67005,36405,9963,Ladakh,0,76968,76968,67005,67005,3000,21,5,16/04/2021
9,9,0,0,Ladakh,0,9,9,9621,9,2,2,0,17/01/2021
2246,3931,1685,231,Ladakh,23,3908,4162,14744,3931,104,39,0,17/02/2021
15870,36397,20524,3700,Ladakh,48,36349,40097,39300,36397,836,171,3,17/03/2021
30661,67157,36491,10662,Ladakh,0,77819,77819,67157,67157,2000,13,5,17/04/2021
49,64,15,0,Ladakh,0,64,64,11660,64,3,3,0,18/01/2021
2296,4284,1988,288,Ladakh,23,4261,4572,14600,4284,118,39,0,18/02/2021
16230,37171,20938,4253,Ladakh,48,37123,41424,40042,37171,881,175,3,18/03/2021
30679,67185,36501,10672,Ladakh,0,77857,77857,67185,67185,3300,22,5,18/04/2021
49,64,15,0,Ladakh,0,64,64,11856,64,4,4,0,19/01/2021
2631,5175,2544,356,Ladakh,23,5152,5531,15088,5175,130,39,0,19/02/2021
16567,37814,21244,4795,Ladakh,48,37766,42609,40709,37814,908,175,3,19/03/2021
30961,67732,36766,12863,Ladakh,0,80595,80595,67732,67732,3100,21,5,19/04/2021
50,66,16,0,Ladakh,0,66,66,11899,66,5,5,0,20/01/2021
16796,38319,21520,5271,Ladakh,48,38271,43590,41165,38319,941,177,3,20/03/2021
31591,68954,37358,15683,Ladakh,0,84637,84637,68954,68954,3400,22,5,20/04/2021
16821,38371,21547,5286,Ladakh,48,38323,43657,41205,38371,949,177,3,21/03/2021
32152,69995,37838,18417,Ladakh,0,88412,88412,69995,69995,3400,20,5,21/04/2021
121,164,43,0,Ladakh,0,164,164,12137,164,12,9,0,22/01/2021
17027,38825,21795,5814,Ladakh,48,38777,44639,41682,38825,974,179,3,22/03/2021
32444,70599,38150,20711,Ladakh,0,91310,91310,70599,70599,3600,22,5,22/04/2021
232,330,98,0,Ladakh,0,330,330,12458,330,12,9,0,23/01/2021
17213,39220,22004,6203,Ladakh,48,39172,45423,42017,39220,990,180,3,23/03/2021
32820,71353,38528,22963,Ladakh,0,94316,94316,71353,71353,3800,26,5,23/04/2021
233,337,104,0,Ladakh,0,337,337,12567,337,13,10,0,24/01/2021
17276,39433,22154,6344,Ladakh,48,39385,45777,42198,39433,1005,180,3,24/03/2021
33004,71714,38705,24825,Ladakh,0,96539,96539,71714,71714,3000,21,5,24/04/2021
313,461,148,0,Ladakh,0,461,461,12777,461,14,11,0,25/01/2021
17352,39613,22258,6631,Ladakh,49,39564,46244,42373,39613,1023,181,3,25/03/2021
33014,71734,38715,25222,Ladakh,0,96956,96956,71734,71734,600,6,5,25/04/2021
313,461,148,0,Ladakh,0,461,461,12779,461,15,11,0,26/01/2021
3193,9412,6219,929,Ladakh,39,9373,10341,12960,9412,200,71,0,26/02/2021
17383,39718,22332,6653,Ladakh,49,39669,46371,42455,39718,1028,181,3,26/03/2021
33525,72754,39224,28149,Ladakh,0,100903,100903,72754,72754,4500,34,5,26/04/2021
408,642,234,0,Ladakh,0,642,642,12912,642,16,12,0,27/01/2021
33938,73508,39564,30209,Ladakh,0,103717,103717,73508,73508,3900,28,6,27/04/2021
411,652,241,0,Ladakh,0,652,652,12985,652,18,13,0,28/01/2021
533,823,290,0,Ladakh,0,823,823,13082,823,19,13,0,29/01/2021
17383,39718,22332,6655,Ladakh,49,39669,46373,42534,39718,1030,181,3,29/03/2021
613,959,346,0,Ladakh,0,959,959,13308,959,19,13,0,30/01/2021
17404,39768,22361,6724,Ladakh,49,39719,46492,42674,39768,1034,181,3,30/03/2021
613,959,346,0,Ladakh,0,959,959,13361,959,20,13,0,31/01/2021
184,807,623,0,Lakshadweep,0,807,807,1672,807,19,12,0,01/02/2021
1371,4692,3321,1807,Lakshadweep,9,4683,6499,5704,4692,577,18,0,01/04/2021
1449,4885,3436,1813,Lakshadweep,9,4876,6698,5919,4885,580,18,0,02/04/2021
1554,5092,3538,1823,Lakshadweep,9,5083,6915,6140,5092,581,18,0,03/04/2021
1969,5912,3942,1834,Lakshadweep,0,7746,7746,5912,5912,1000,10,1,04/04/2021
198,825,627,0,Lakshadweep,0,825,825,1807,825,26,13,0,05/02/2021
430,1856,1426,126,Lakshadweep,4,1852,1982,2855,1856,115,15,0,05/03/2021
2045,6130,4084,1863,Lakshadweep,0,7993,7993,6130,6130,1100,11,1,05/04/2021
199,833,634,0,Lakshadweep,0,833,833,2104,833,26,13,0,06/02/2021
455,1939,1484,139,Lakshadweep,4,1935,2078,2935,1939,124,15,0,06/03/2021
2215,6501,4285,1933,Lakshadweep,0,8434,8434,6501,6501,1100,10,1,06/04/2021
199,833,634,0,Lakshadweep,0,833,833,2272,833,26,13,0,07/02/2021
2648,7379,4730,2105,Lakshadweep,0,9484,9484,7379,7379,1100,11,1,07/04/2021
200,839,639,0,Lakshadweep,0,839,839,2347,839,30,13,0,08/02/2021
514,2121,1607,189,Lakshadweep,7,2114,2310,3139,2121,189,15,0,08/03/2021
3039,8312,5272,2309,Lakshadweep,0,10621,10621,8312,8312,1200,12,1,08/04/2021
204,869,665,0,Lakshadweep,0,869,869,2393,869,30,13,0,09/02/2021
551,2248,1697,216,Lakshadweep,9,2239,2464,3270,2248,194,15,0,09/03/2021
3376,9063,5685,2464,Lakshadweep,0,11527,11527,9063,9063,1100,11,2,09/04/2021
286,1312,1026,0,Lakshadweep,0,1312,1312,2394,1312,34,13,0,10/02/2021
577,2387,1810,321,Lakshadweep,9,2378,2708,3362,2387,266,15,0,10/03/2021
3866,10150,6282,2557,Lakshadweep,0,12707,12707,10150,10150,1500,13,2,10/04/2021
603,2574,1971,470,Lakshadweep,9,2565,3044,3546,2574,282,15,0,11/03/2021
4087,10630,6541,2593,Lakshadweep,0,13223,13223,10630,10630,1300,12,2,11/04/2021
336,1575,1239,0,Lakshadweep,0,1575,1575,2434,1575,35,13,0,12/02/2021
624,2778,2154,674,Lakshadweep,9,2769,3452,3752,2778,288,15,0,12/03/2021
4355,11139,6782,2652,Lakshadweep,0,13791,13791,11139,11139,1100,11,2,12/04/2021
669,3005,2336,859,Lakshadweep,9,2996,3864,3977,3005,288,15,0,13/03/2021
4629,11691,7060,2698,Lakshadweep,0,14389,14389,11691,11691,1100,11,2,13/04/2021
336,1575,1239,0,Lakshadweep,0,1575,1575,2445,1575,36,13,0,14/02/2021
669,3018,2349,888,Lakshadweep,9,3009,3906,3988,3018,288,15,0,14/03/2021
4987,12470,7480,2805,Lakshadweep,0,15275,15275,12470,12470,1000,10,3,14/04/2021
336,1575,1239,0,Lakshadweep,0,1575,1575,2804,1575,37,13,0,15/02/2021
717,3159,2442,998,Lakshadweep,9,3150,4157,4128,3159,394,15,0,15/03/2021
5284,13174,7886,2879,Lakshadweep,0,16053,16053,13174,13174,1100,11,4,15/04/2021
2,16,14,0,Lakshadweep,0,16,16,776,16,1,1,0,16/01/2021
796,3300,2504,1116,Lakshadweep,9,3291,4416,4268,3300,471,15,0,16/03/2021
5460,13529,8065,2917,Lakshadweep,0,16446,16446,13529,13529,1200,12,4,16/04/2021
349,1594,1245,19,Lakshadweep,0,1594,1613,2904,1594,41,13,0,17/02/2021
805,3342,2537,1144,Lakshadweep,9,3333,4486,4308,3342,482,15,0,17/03/2021
5780,14161,8378,2984,Lakshadweep,0,17145,17145,14161,14161,1400,14,3,17/04/2021
8,237,229,0,Lakshadweep,0,237,237,742,237,10,9,0,18/01/2021
359,1623,1264,51,Lakshadweep,0,1623,1674,2638,1623,49,13,0,18/02/2021
835,3480,2645,1295,Lakshadweep,9,3471,4775,4444,3480,485,15,0,18/03/2021
6213,14933,8717,3080,Lakshadweep,0,18013,18013,14933,14933,1000,10,3,18/04/2021
871,3544,2673,1363,Lakshadweep,9,3535,4907,4510,3544,488,15,0,19/03/2021
6371,15300,8926,3139,Lakshadweep,0,18439,18439,15300,15300,1000,10,3,19/04/2021
936,3628,2692,1487,Lakshadweep,9,3619,5115,4590,3628,489,15,0,20/03/2021
6516,15609,9090,3285,Lakshadweep,0,18894,18894,15609,15609,1000,10,3,20/04/2021
937,3632,2695,1489,Lakshadweep,9,3623,5121,4593,3632,489,15,0,21/03/2021
6827,16225,9395,3525,Lakshadweep,0,19750,19750,16225,16225,1100,11,3,21/04/2021
146,734,588,0,Lakshadweep,0,734,734,802,734,14,12,0,22/01/2021
964,3708,2744,1518,Lakshadweep,9,3699,5226,4670,3708,489,15,0,22/03/2021
6979,16523,9541,3617,Lakshadweep,0,20140,20140,16523,16523,1100,11,3,22/04/2021
146,734,588,0,Lakshadweep,0,734,734,887,734,14,12,0,23/01/2021
1003,3800,2797,1577,Lakshadweep,9,3791,5377,4761,3800,489,15,0,23/03/2021
7144,16836,9689,3708,Lakshadweep,0,20544,20544,16836,16836,1000,10,3,23/04/2021
161,749,588,0,Lakshadweep,0,749,749,1236,749,14,12,0,24/01/2021
1028,3874,2846,1608,Lakshadweep,9,3865,5482,4835,3874,493,15,0,24/03/2021
7376,17253,9874,3769,Lakshadweep,0,21022,21022,17253,17253,1100,11,3,24/04/2021
1048,3888,2840,1639,Lakshadweep,9,3879,5527,4849,3888,493,15,0,25/03/2021
7519,17538,10016,3825,Lakshadweep,0,21363,21363,17538,17538,1300,12,3,25/04/2021
414,1824,1410,107,Lakshadweep,4,1820,1931,2823,1824,55,13,0,26/02/2021
1087,3979,2892,1663,Lakshadweep,9,3970,5642,4939,3979,493,15,0,26/03/2021
7678,17843,10162,3889,Lakshadweep,0,21732,21732,17843,17843,1000,10,3,26/04/2021
153,765,612,0,Lakshadweep,0,765,765,1266,765,19,12,0,27/01/2021
1172,4169,2997,1683,Lakshadweep,9,4160,5852,5130,4169,496,15,0,27/03/2021
7779,17998,10217,3930,Lakshadweep,0,21928,21928,17998,17998,1200,12,2,27/04/2021
1196,4214,3018,1694,Lakshadweep,9,4205,5908,5176,4214,512,16,0,28/03/2021
1196,4214,3018,1694,Lakshadweep,9,4205,5908,5179,4214,513,16,0,29/03/2021
184,807,623,0,Lakshadweep,0,807,807,1287,807,19,12,0,30/01/2021
1228,4358,3130,1762,Lakshadweep,9,4349,6120,5324,4358,547,16,0,30/03/2021
184,807,623,0,Lakshadweep,0,807,807,1435,807,19,12,0,31/01/2021
1313,4562,3249,1797,Lakshadweep,9,4553,6359,5549,4562,572,18,0,31/03/2021
205542,286538,80992,0,Madhya Pradesh,0,286538,286538,457792,286538,6637,1592,4,01/02/2021
1353111,2921029,1567635,516221,Madhya Pradesh,223579,2697450,3437250,3106643,2921029,99062,6347,283,01/04/2021
205739,286868,81125,0,Madhya Pradesh,0,286868,286868,459801,286868,7373,1634,4,02/02/2021
297830,664726,366883,181761,Madhya Pradesh,120472,544254,846487,788208,664726,20736,2036,13,02/03/2021
1443819,3118920,1674797,522642,Madhya Pradesh,231342,2887578,3641562,3286013,3118920,102660,6395,304,02/04/2021
228612,319623,91007,0,Madhya Pradesh,0,319623,319623,501245,319623,7831,1642,4,03/02/2021
316141,706334,390174,201717,Madhya Pradesh,120473,585861,908051,831419,706334,22292,2044,19,03/03/2021
1511954,3269930,1757658,529103,Madhya Pradesh,247771,3022159,3799033,3465175,3269930,106368,6489,318,03/04/2021
236004,329571,93563,0,Madhya Pradesh,0,329571,329571,532593,329571,7992,1642,4,04/02/2021
337329,754152,416801,216379,Madhya Pradesh,120488,633664,970531,880601,754152,22619,2045,22,04/03/2021
1697721,3675945,1977803,538599,Madhya Pradesh,373561,3840983,4214544,3675945,3675945,190991,778,421,04/04/2021
236883,331316,94429,0,Madhya Pradesh,0,331316,331316,558960,331316,8093,1657,4,05/02/2021
340114,760376,420240,218325,Madhya Pradesh,120497,639879,978701,886208,760376,23876,2057,22,05/03/2021
1769793,3831368,2061133,544665,Madhya Pradesh,444884,3931149,4376033,3831368,3831368,416609,2360,442,05/04/2021
238046,332832,94782,0,Madhya Pradesh,0,332832,332832,576375,332832,8962,1791,4,06/02/2021
366083,817810,451693,232036,Madhya Pradesh,120498,697312,1049846,946132,817810,25490,2068,34,06/03/2021
1837489,3977455,2139507,550755,Madhya Pradesh,508381,4019829,4528210,3977455,3977455,414416,1999,459,06/04/2021
238484,333677,95189,0,Madhya Pradesh,0,333677,333677,582595,333677,9183,1829,4,07/02/2021
366947,819884,452903,232219,Madhya Pradesh,120498,699386,1052103,947140,819884,27014,2107,34,07/03/2021
2005206,4334898,2329211,567564,Madhya Pradesh,567777,4334685,4902462,4334898,4334898,590355,3590,481,07/04/2021
243128,369141,126007,0,Madhya Pradesh,14365,354776,369141,602862,369141,9500,1831,6,08/02/2021
392261,878269,485971,245103,Madhya Pradesh,121063,757206,1123372,1007161,878269,27837,2125,37,08/03/2021
2157893,4649680,2491279,583488,Madhya Pradesh,607953,4625215,5233168,4649680,4649680,479140,2771,508,08/04/2021
243652,373504,129846,0,Madhya Pradesh,16081,357423,373504,614056,373504,10102,1845,6,09/02/2021
394148,882265,488080,245740,Madhya Pradesh,121080,761185,1128005,1010826,882265,29819,2175,37,09/03/2021
2216665,4770269,2553081,591710,Madhya Pradesh,625339,4736640,5361979,4770269,4770269,423998,2072,523,09/04/2021
250586,427715,177123,0,Madhya Pradesh,39668,388047,427715,638559,427715,10797,1887,6,10/02/2021
420873,942537,521623,278253,Madhya Pradesh,122275,820262,1220790,1071265,942537,30818,2218,41,10/03/2021
2260414,4866494,2605546,598431,Madhya Pradesh,639725,4825200,5464925,4866494,4866494,279011,1670,534,10/04/2021
257789,482095,224299,0,Madhya Pradesh,61581,420514,482095,660528,482095,11467,1918,7,11/02/2021
421430,943719,522248,278690,Madhya Pradesh,122292,821427,1222409,1072354,943719,31716,2306,41,11/03/2021
2429350,5222120,2792192,615029,Madhya Pradesh,652277,5184872,5837149,5222120,5222120,725864,4548,578,11/04/2021
263033,519589,256549,0,Madhya Pradesh,76489,443100,519589,678715,519589,12108,1945,7,12/02/2021
423443,948278,524793,280309,Madhya Pradesh,122458,825820,1228587,1076991,948278,34525,2514,42,12/03/2021
2610251,5603174,2992300,641351,Madhya Pradesh,658902,5585623,6244525,5603174,5603174,710930,4869,623,12/04/2021
266962,548272,281302,3,Madhya Pradesh,87755,460517,548275,698206,548272,12437,1958,8,13/02/2021
473856,1062458,588548,334560,Madhya Pradesh,125488,936970,1397018,1192284,1062458,36974,2624,54,13/03/2021
2748380,5899933,3150904,658236,Madhya Pradesh,660324,5897845,6558169,5899933,5899933,813940,5055,649,13/04/2021
266979,548466,281479,3,Madhya Pradesh,87757,460709,548469,705923,548466,12803,1962,8,14/02/2021
474849,1064529,589626,334839,Madhya Pradesh,125516,939013,1399368,1193944,1064529,39876,2737,54,14/03/2021
2893799,6202259,3307757,684657,Madhya Pradesh,661830,6225086,6886916,6202259,6202259,841205,5366,703,14/04/2021
269348,565952,296596,5,Madhya Pradesh,94273,471679,565957,728429,565952,12994,1968,8,15/02/2021
530395,1192192,661735,375326,Madhya Pradesh,128144,1064048,1567518,1328145,1192192,43988,2761,62,15/03/2021
2961330,6348519,3386461,708641,Madhya Pradesh,662727,6394433,7057160,6348519,6348519,476241,3266,728,15/04/2021
4368,9435,5066,0,Madhya Pradesh,0,9435,9435,304726,9435,183,156,1,16/01/2021
269664,567586,297914,5,Madhya Pradesh,95034,472552,567591,741811,567586,13481,1981,8,16/02/2021
536127,1204553,668363,377588,Madhya Pradesh,128311,1076242,1582141,1336228,1204553,47086,2850,63,16/03/2021
2981593,6392872,3410549,722760,Madhya Pradesh,663804,6451828,7115632,6392872,6392872,628587,3868,730,16/04/2021
4368,9435,5066,0,Madhya Pradesh,0,9435,9435,306187,9435,458,158,1,17/01/2021
272862,587652,314782,6,Madhya Pradesh,102594,485058,587658,789201,587652,13944,1982,8,17/02/2021
605122,1357620,752416,411580,Madhya Pradesh,130855,1226765,1769200,1493600,1357620,49756,3135,82,17/03/2021
3052493,6546917,3493665,757255,Madhya Pradesh,664846,6639326,7304172,6546917,6546917,584043,4150,759,17/04/2021
9134,15934,6799,0,Madhya Pradesh,0,15934,15934,309206,15934,467,158,1,18/01/2021
273555,598319,324756,9,Madhya Pradesh,107696,490623,598328,727727,598319,14604,1993,8,18/02/2021
671533,1501557,829927,432067,Madhya Pradesh,132920,1368637,1933624,1638340,1501557,52843,3940,97,18/03/2021
3061458,6566352,3504133,763445,Madhya Pradesh,665122,6664675,7329797,6566352,6566352,431730,2790,761,18/04/2021
10341,18409,8067,0,Madhya Pradesh,0,18409,18409,316767,18409,630,160,1,19/01/2021
279169,616782,337605,23,Madhya Pradesh,112750,504032,616805,834805,616782,15120,2000,8,19/02/2021
676662,1512330,835567,433193,Madhya Pradesh,132938,1379392,1945523,1647590,1512330,58953,4956,101,19/03/2021
3122429,6700964,3577751,805419,Madhya Pradesh,685389,6820994,7506383,6700964,6700964,639278,4578,784,19/04/2021
16800,27769,10968,0,Madhya Pradesh,0,27769,27769,320535,27769,798,163,1,20/01/2021
283917,631637,347712,3809,Madhya Pradesh,117418,514219,635446,838030,631637,15420,2004,8,20/02/2021
807150,1784005,976735,456106,Madhya Pradesh,141535,1642470,2240111,1944620,1784005,62866,5172,120,20/03/2021
3133011,6725608,3591813,817311,Madhya Pradesh,692403,6850516,7542919,6725608,6725608,468862,3204,784,20/04/2021
24168,38425,14256,0,Madhya Pradesh,0,38425,38425,324164,38425,798,163,1,21/01/2021
284013,632248,348227,3809,Madhya Pradesh,117779,514469,636057,838177,632248,15687,2010,8,21/02/2021
832116,1834319,1002073,459046,Madhya Pradesh,143903,1690416,2293365,1974848,1834319,67046,5407,130,21/03/2021
3138678,6737838,3598373,828441,Madhya Pradesh,694256,6872023,7566279,6737838,6737838,350020,2337,787,21/04/2021
24168,38425,14256,0,Madhya Pradesh,0,38425,38425,338267,38425,1111,335,1,22/01/2021
285095,635089,349986,31670,Madhya Pradesh,118252,516837,666759,838220,635089,15970,2010,8,22/02/2021
917969,2011652,1093522,471612,Madhya Pradesh,155455,1856197,2483264,2173761,2011652,68954,5440,161,22/03/2021
3189880,6850130,3659443,886674,Madhya Pradesh,703028,7033776,7736804,6850130,6850130,628720,4746,807,22/04/2021
24168,38428,14259,0,Madhya Pradesh,0,38428,38428,346476,38428,1749,491,1,23/01/2021
285287,636139,350844,32634,Madhya Pradesh,118565,517574,668773,838283,636139,16587,2013,8,23/02/2021
946054,2069350,1123125,475060,Madhya Pradesh,160553,1908797,2544410,2213581,2069350,73067,5539,171,23/03/2021
3199738,6871962,3671408,902392,Madhya Pradesh,705551,7068803,7774354,6871962,6871962,308207,2047,816,23/04/2021
24168,38430,14261,0,Madhya Pradesh,0,38430,38430,347914,38430,1816,493,1,24/01/2021
286291,639425,353126,77257,Madhya Pradesh,119504,519921,716682,838561,639425,17424,2015,8,24/02/2021
1063553,2308946,1245190,485522,Madhya Pradesh,177905,2131041,2794468,2458406,2308946,76325,5588,203,24/03/2021
3232300,6942784,3709657,952601,Madhya Pradesh,713166,7182219,7895385,6942784,6942784,551060,4096,827,24/04/2021
43461,66875,23413,0,Madhya Pradesh,0,66875,66875,359509,66875,2294,711,1,25/01/2021
287678,642871,355185,130357,Madhya Pradesh,120126,522745,773228,838609,642871,18289,2015,8,25/02/2021
1128253,2442311,1313840,492086,Madhya Pradesh,191694,2250617,2934397,2591115,2442311,78105,5633,218,25/03/2021
3235596,6949787,3713363,958924,Madhya Pradesh,714407,7194304,7908711,6949787,6949787,74730,425,828,25/04/2021
43461,66877,23415,0,Madhya Pradesh,0,66877,66877,363743,66877,2985,1102,1,26/01/2021
288644,644716,356064,159662,Madhya Pradesh,120373,524343,804378,767644,644716,18440,2015,8,26/02/2021
1131060,2448443,1317162,492513,Madhya Pradesh,192431,2256012,2940956,2596662,2448443,79576,5687,221,26/03/2021
3253341,6988355,3734180,1003182,Madhya Pradesh,721652,7269885,7991537,6988355,6988355,465321,3387,834,26/04/2021
93475,131099,37622,0,Madhya Pradesh,0,131099,131099,383831,131099,3931,1324,2,27/01/2021
288644,644716,356064,159662,Madhya Pradesh,120373,524343,804378,767817,644716,18440,2015,8,27/02/2021
1177644,2546738,1368859,497004,Madhya Pradesh,204657,2342081,3043742,2696586,2546738,81404,5724,235,27/03/2021
3257287,6996487,3738364,1013987,Madhya Pradesh,722336,7288138,8010474,6996487,6996487,368543,2756,836,27/04/2021
139957,192628,52669,0,Madhya Pradesh,0,192628,192628,402228,192628,5111,1457,2,28/01/2021
1179156,2549671,1370279,497238,Madhya Pradesh,205264,2344407,3046909,2698699,2549671,82300,5738,236,28/03/2021
169000,234631,65629,0,Madhya Pradesh,0,234631,234631,423581,234631,6093,1544,2,29/01/2021
1179159,2549681,1370286,497242,Madhya Pradesh,205264,2344417,3046923,2698736,2549681,83980,5759,236,29/03/2021
204275,284782,80503,0,Madhya Pradesh,0,284782,284782,445512,284782,6115,1553,4,30/01/2021
1180056,2551605,1371313,497434,Madhya Pradesh,205278,2346327,3049039,2700674,2551605,89091,5967,236,30/03/2021
204836,285481,80641,0,Madhya Pradesh,0,285481,285481,449242,285481,6287,1565,4,31/01/2021
1246504,2690724,1443966,507960,Madhya Pradesh,214675,2476049,3198684,2842586,2690724,94692,6196,254,31/03/2021
175829,275348,99441,0,Maharashtra,2708,272640,275348,1075255,275348,5753,744,78,01/02/2021
2072376,4557627,2484800,759579,Maharashtra,623749,3933878,5317206,5404881,4557627,195434,6570,451,01/04/2021
180812,284107,103217,0,Maharashtra,2760,281347,284107,1083981,284107,6234,778,78,02/02/2021
487976,1071612,583429,179807,Maharashtra,14917,1056695,1251419,1888015,1071612,29090,1560,207,02/03/2021
2185712,4805368,2619177,772069,Maharashtra,650813,4154555,5577437,5655831,4805368,203302,6757,479,02/04/2021
201467,318918,117360,0,Maharashtra,3170,315748,318918,1106384,318918,6895,830,91,03/02/2021
508266,1119835,611358,197501,Maharashtra,16279,1103556,1317336,1932294,1119835,35097,1892,211,03/03/2021
2296538,5045558,2748524,784171,Maharashtra,669944,4375614,5829729,5924547,5045558,211138,6967,496,03/04/2021
220669,352676,131909,0,Maharashtra,3691,348985,352676,1132718,352676,7584,874,98,04/02/2021
532164,1174258,641880,213731,Maharashtra,18652,1155606,1387989,1986198,1174258,39672,2084,214,04/03/2021
3158056,6841397,3682530,805729,Maharashtra,876863,6770263,7647126,6841397,6841397,525322,3715,811,04/04/2021
245610,397889,152168,0,Maharashtra,3942,393947,397889,1168259,397889,8449,926,111,05/02/2021
563432,1244617,680964,234417,Maharashtra,20513,1224104,1479034,2055271,1244617,46743,2341,221,05/03/2021
3314856,7167016,3851303,822149,Maharashtra,894246,7094919,7989165,7167016,7167016,752060,5159,857,05/04/2021
264525,436229,171578,0,Maharashtra,4205,432024,436229,1222846,436229,9141,955,126,06/02/2021
599889,1325264,725150,259577,Maharashtra,22376,1302888,1584841,2132554,1325264,54326,2757,225,06/03/2021
3436823,7421245,3983541,835795,Maharashtra,906206,7350834,8257040,7421245,7421245,719948,5124,881,06/04/2021
264602,436400,171672,0,Maharashtra,4206,432194,436400,1265771,436400,9455,969,126,07/02/2021
602724,1331000,728051,260448,Maharashtra,22432,1308568,1591448,2138958,1331000,59458,3143,225,07/03/2021
3701369,7988151,4285845,868513,Maharashtra,938502,7918162,8856664,7988151,7988151,748140,5192,937,07/04/2021
282839,475193,192223,0,Maharashtra,4472,470721,475193,1316860,475193,10161,1027,131,08/02/2021
659947,1454112,793934,285711,Maharashtra,27182,1426930,1739823,2264315,1454112,64230,3409,231,08/03/2021
3903507,8434286,4529795,903504,Maharashtra,970024,8367766,9337790,8434286,8434286,723318,5242,984,08/04/2021
293586,503757,210039,0,Maharashtra,4732,499025,503757,1353214,503757,11054,1109,132,09/02/2021
696211,1536355,839907,305927,Maharashtra,29698,1506657,1842282,2346229,1536355,69245,3540,237,09/03/2021
4022623,8702273,4678646,930126,Maharashtra,1000843,8631556,9632399,8702273,8702273,695890,4940,1004,09/04/2021
310353,544726,234241,0,Maharashtra,4877,539849,544726,1395113,544726,12032,1147,132,10/02/2021
765016,1687750,922488,338709,Maharashtra,36551,1651199,2026459,2497828,1687750,74564,3644,246,10/03/2021
4141511,8969876,4827326,953377,Maharashtra,1025624,8897629,9923253,8969876,8969876,626527,4275,1039,10/04/2021
323314,579241,255793,0,Maharashtra,5018,574223,579241,1443232,579241,12846,1205,134,11/02/2021
785912,1734147,947989,348804,Maharashtra,37223,1696924,2082951,2544598,1734147,77797,3700,246,11/03/2021
4257679,9220161,4961415,971735,Maharashtra,1043756,9148140,10191896,9220161,9220161,641340,4292,1067,11/04/2021
338533,620539,281870,0,Maharashtra,5258,615281,620539,1498065,620539,13641,1227,136,12/02/2021
860063,1900122,1039801,383425,Maharashtra,45358,1854764,2283547,2712459,1900122,83421,3761,258,12/03/2021
4394334,9519815,5124361,1008604,Maharashtra,1075618,9452801,10528419,9519815,9519815,722595,4880,1120,12/04/2021
349645,652801,303019,170,Maharashtra,5403,647398,652971,1546635,652801,14251,1239,137,13/02/2021
908680,2006329,1097386,411776,Maharashtra,51243,1955086,2418105,2817264,2006329,88612,3834,263,13/03/2021
4479847,9717561,5236582,1035890,Maharashtra,1086699,9666752,10753451,9717561,9717561,788245,5532,1132,13/04/2021
349702,653135,303296,170,Maharashtra,5403,647732,653305,1555831,653135,14559,1254,137,14/02/2021
911720,2013155,1101171,412322,Maharashtra,52018,1961137,2425477,2823848,2013155,93180,3952,264,14/03/2021
4634179,10038913,5403569,1086062,Maharashtra,1103553,10021422,11124975,10038913,10038913,834266,5854,1165,14/04/2021
360058,682610,322414,4527,Maharashtra,5771,676839,687137,1609707,682610,15389,1270,138,15/02/2021
996578,2198788,1201925,444527,Maharashtra,70402,2128386,2643315,3015787,2198788,98703,4038,285,15/03/2021
4778365,10356338,5576754,1154685,Maharashtra,1129851,10381172,11511023,10356338,10356338,852755,6005,1219,15/04/2021
2057,5726,3668,0,Maharashtra,85,5641,5726,812649,5726,179,174,1,16/01/2021
369626,711043,341277,8901,Maharashtra,6176,704867,719944,1671062,711043,16315,1286,140,16/02/2021
1050150,2318045,1267600,468829,Maharashtra,95792,2222253,2786874,3133701,2318045,104159,4186,295,16/03/2021
4915732,10658902,5741917,1226928,Maharashtra,1161603,10724227,11885830,10658902,10658902,850505,5884,1253,16/04/2021
2566,6521,3953,0,Maharashtra,94,6427,6521,814714,6521,269,216,2,17/01/2021
384760,752088,367162,16607,Maharashtra,6713,745375,768695,1762055,752088,17230,1320,166,17/02/2021
1138601,2509141,1370232,500559,Maharashtra,136887,2372254,3009700,3324908,2509141,110445,4388,308,17/03/2021
4999988,10849828,5848545,1289143,Maharashtra,1206905,10932066,12138971,10849828,10849828,728045,4921,1295,17/04/2021
2581,6151,3569,0,Maharashtra,105,6046,6151,811257,6151,772,320,1,18/01/2021
391467,787086,395447,23820,Maharashtra,7323,779763,810906,1726304,787086,17972,1331,172,18/02/2021
1198684,2643307,1444310,525974,Maharashtra,184321,2458986,3169281,3460018,2643307,115988,4587,313,18/03/2021
5049845,10959390,5908230,1314373,Maharashtra,1225133,11048630,12273763,10959390,10959390,778701,5168,1315,18/04/2021
7367,13699,6328,0,Maharashtra,214,13485,13699,850966,13699,1196,340,4,19/01/2021
409681,825846,415984,27528,Maharashtra,7694,818152,853374,1842069,825846,18682,1343,181,19/02/2021
1272175,2804796,1532302,556400,Maharashtra,229857,2574939,3361196,3630326,2804796,121704,4736,319,19/03/2021
5176641,11240031,6062034,1409299,Maharashtra,1305411,11343919,12649330,11240031,11240031,870145,5816,1356,19/04/2021
14205,23880,9658,0,Maharashtra,439,23441,23880,870296,23880,1547,347,17,20/01/2021
422875,868244,445173,45414,Maharashtra,8295,859949,913658,1851654,868244,19394,1347,196,20/02/2021
1337923,2948586,1610335,589256,Maharashtra,289094,2659492,3537842,3769799,2948586,126710,4868,328,20/03/2021
5268751,11447258,6177116,1497461,Maharashtra,1401015,11543704,12944719,11447258,11447258,899635,6078,1391,20/04/2021
14347,24148,9784,0,Maharashtra,443,23705,24148,880118,24148,1820,357,17,21/01/2021
424540,871567,446831,46395,Maharashtra,8332,863235,917962,1853272,871567,19869,1352,196,21/02/2021
1349534,2974365,1624500,593986,Maharashtra,298970,2675395,3568351,3788740,2974365,130814,5005,331,21/03/2021
5384230,11691829,6306172,1587560,Maharashtra,1457704,11821685,13279389,11691829,11691829,878010,5917,1427,21/04/2021
27802,44369,16546,0,Maharashtra,840,43529,44369,902635,44369,2012,374,21,22/01/2021
434486,907200,472516,67861,Maharashtra,9341,897859,975061,1858133,907200,20789,1368,198,22/02/2021
1427710,3144487,1716433,622278,Maharashtra,357981,2786506,3766765,3973668,3144487,138780,5107,344,22/03/2021
5512485,11966150,6452197,1707683,Maharashtra,1518540,12155293,13673833,11966150,11966150,921785,6287,1468,22/04/2021
43937,69295,25333,0,Maharashtra,1156,68139,69295,921922,69295,2435,483,25,23/01/2021
442893,938078,494986,79336,Maharashtra,10284,927794,1017414,1861115,938078,21730,1380,199,23/02/2021
1497939,3300203,1801912,649748,Maharashtra,412877,2887326,3949951,4116072,3300203,144330,5155,352,23/03/2021
5611811,12184886,6571578,1815052,Maharashtra,1568825,12431113,13999938,12184886,12184886,889740,5950,1497,23/04/2021
44510,70196,25661,0,Maharashtra,1157,69039,70196,925794,70196,2756,581,25,24/01/2021
452680,969314,516434,104475,Maharashtra,11427,957887,1073789,1862473,969314,22574,1386,200,24/02/2021
1585305,3490056,1904378,669780,Maharashtra,458988,3031068,4159836,4307309,3490056,149043,5220,373,24/03/2021
5677836,12326873,6647519,1903104,Maharashtra,1611245,12618732,14229977,12326873,12326873,757640,4899,1518,24/04/2021
68527,107073,38512,0,Maharashtra,1433,105640,107073,950534,107073,3170,617,34,25/01/2021
461032,997308,536075,130773,Maharashtra,12205,985103,1128081,1863176,997308,23689,1395,201,25/02/2021
1655215,3647933,1992336,685120,Maharashtra,491933,3156000,4333053,4466527,3647933,154203,5326,382,25/03/2021
5715713,12404273,6687026,1937912,Maharashtra,1622286,12719899,14342185,12404273,12404273,639205,3985,1534,25/04/2021
68728,107338,38562,0,Maharashtra,1433,105905,107338,952905,107338,3435,646,48,26/01/2021
470681,1028360,557475,158658,Maharashtra,13184,1015176,1187018,1851874,1028360,24016,1399,204,26/02/2021
1745671,3846947,2100879,704824,Maharashtra,522229,3324718,4551771,4669792,3846947,159296,5417,397,26/03/2021
5889111,12768316,6877612,2137509,Maharashtra,1656856,13248969,14905825,12768316,12768316,912735,6173,1593,26/04/2021
96795,150102,53245,0,Maharashtra,1642,148460,150102,980122,150102,4050,668,62,27/01/2021
1825879,4021836,2195548,718212,Maharashtra,547205,3474631,4740048,4841597,4021836,164585,5622,409,27/03/2021
6013031,13030894,7016228,2290836,Maharashtra,1701178,13620552,15321730,13030894,13030894,904295,6071,1635,27/04/2021
122840,189743,66834,0,Maharashtra,1893,187850,189743,1005606,189743,4570,685,69,28/01/2021
470713,1028520,557603,158658,Maharashtra,13184,1015336,1187178,1851875,1028520,24508,1407,204,28/02/2021
1832875,4038355,2205071,718936,Maharashtra,550290,3488065,4757291,4857610,4038355,169139,5689,409,28/03/2021
145999,225132,79060,0,Maharashtra,2193,222939,225132,1032941,225132,4814,702,73,29/01/2021
1849386,4075506,2225708,721465,Maharashtra,556492,3519014,4796971,4895234,4075506,172597,5708,412,29/03/2021
151156,233693,82464,0,Maharashtra,2282,231411,233693,1044581,233693,5150,723,73,30/01/2021
1919677,4224812,2304713,733774,Maharashtra,580307,3644505,4958586,5047577,4224812,181034,5963,422,30/03/2021
151449,234150,82628,0,Maharashtra,2282,231868,234150,1049628,234150,5309,733,73,31/01/2021
1994354,4387945,2393154,749358,Maharashtra,601535,3786410,5137303,5213641,4387945,187143,6265,437,31/03/2021
1740,3321,1581,0,Manipur,0,3321,3321,89301,3321,124,27,0,01/02/2021
26877,83011,56131,31967,Manipur,97,82914,114978,142633,83011,3921,224,3,01/04/2021
1926,3614,1688,0,Manipur,0,3614,3614,89444,3614,140,33,0,02/02/2021
22200,51010,28809,2721,Manipur,39,50971,53731,127746,51010,1375,203,1,02/03/2021
26896,83218,56319,32276,Manipur,97,83121,115494,142798,83218,3966,224,3,02/04/2021
2596,4683,2086,0,Manipur,0,4683,4683,96216,4683,149,37,1,03/02/2021
22381,54240,31858,3127,Manipur,39,54201,57367,128747,54240,1457,206,1,03/03/2021
27056,84124,57065,34027,Manipur,98,84026,118151,143467,84124,4032,224,3,03/04/2021
2759,4882,2122,0,Manipur,0,4882,4882,98233,4882,159,39,1,04/02/2021
22455,56584,34128,3368,Manipur,45,56539,59952,129252,56584,1561,207,1,04/03/2021
27093,83536,56441,34447,Manipur,0,117983,117983,83536,83536,4750,39,2,04/04/2021
3279,5638,2358,0,Manipur,0,5638,5638,102985,5638,185,52,1,05/02/2021
22647,59034,36386,3832,Manipur,47,58987,62866,130076,59034,1691,211,1,05/03/2021
27192,84193,56999,35973,Manipur,0,120166,120166,84193,84193,7900,72,2,05/04/2021
4096,6981,2884,0,Manipur,0,6981,6981,103962,6981,194,55,1,06/02/2021
22893,61879,38985,4539,Manipur,49,61830,66418,131291,61879,1741,213,1,06/03/2021
27282,84616,57332,36895,Manipur,0,121511,121511,84616,84616,8300,75,2,06/04/2021
4182,7085,2902,0,Manipur,0,7085,7085,104991,7085,209,64,1,07/02/2021
22893,61932,39038,4553,Manipur,50,61882,66485,131301,61932,1831,214,1,07/03/2021
27529,85872,58341,39137,Manipur,0,125009,125009,85872,85872,7700,69,2,07/04/2021
5242,8785,3542,0,Manipur,0,8785,8785,106635,8785,236,74,1,08/02/2021
23071,63908,40835,5748,Manipur,53,63855,69656,132128,63908,1905,215,2,08/03/2021
27754,86907,59151,41189,Manipur,0,128096,128096,86907,86907,5350,44,2,08/04/2021
5915,9895,3979,0,Manipur,0,9895,9895,109162,9895,281,98,1,09/02/2021
23172,65521,42347,6099,Manipur,60,65461,71620,132826,65521,2017,215,2,09/03/2021
28065,88290,60223,42653,Manipur,0,130943,130943,88290,88290,10500,90,2,09/04/2021
7377,12509,5131,0,Manipur,0,12509,12509,110565,12509,321,118,1,10/02/2021
23320,66886,43564,7352,Manipur,63,66823,74238,133435,66886,2113,216,2,10/03/2021
28187,88814,60625,43386,Manipur,0,132200,132200,88814,88814,3400,32,2,10/04/2021
8644,14562,5917,0,Manipur,0,14562,14562,112068,14562,383,136,1,11/02/2021
23403,67783,44378,8158,Manipur,75,67708,75941,133763,67783,2246,217,2,11/03/2021
28617,90439,61820,43957,Manipur,0,134396,134396,90439,90439,11959,106,2,11/04/2021
10928,17996,7067,0,Manipur,3,17993,17996,113988,17996,445,147,1,12/02/2021
23612,69175,45561,9593,Manipur,77,69098,78768,134495,69175,2317,217,2,12/03/2021
29269,92519,63247,45161,Manipur,0,137680,137680,92519,92519,12580,117,3,12/04/2021
12855,20811,7955,55,Manipur,4,20807,20866,116080,20811,478,153,1,13/02/2021
23780,69802,46020,10042,Manipur,79,69723,79844,134909,69802,2349,217,2,13/03/2021
29920,94163,64239,45802,Manipur,0,139965,139965,94163,94163,12900,119,4,13/04/2021
13246,21284,8037,169,Manipur,4,21280,21453,117116,21284,534,157,1,14/02/2021
30778,96373,65590,46499,Manipur,0,142872,142872,96373,96373,12050,115,5,14/04/2021
14874,24144,9269,284,Manipur,4,24140,24428,118473,24144,593,161,1,15/02/2021
23975,71134,47157,11860,Manipur,80,71054,82994,135583,71134,2546,218,2,15/03/2021
31280,97755,66470,47694,Manipur,0,145449,145449,97755,97755,11750,110,5,15/04/2021
69,181,112,0,Manipur,0,181,181,57599,181,10,10,0,16/01/2021
16464,27091,10626,415,Manipur,8,27083,27506,120747,27091,682,173,1,16/02/2021
24182,71944,47760,13076,Manipur,80,71864,85020,136048,71944,2671,219,2,16/03/2021
32119,99881,67757,48705,Manipur,0,148586,148586,99881,99881,13000,121,5,16/04/2021
76,192,116,0,Manipur,0,192,192,62025,192,19,12,0,17/01/2021
18854,30988,12133,673,Manipur,9,30979,31661,123840,30988,759,176,1,17/02/2021
24568,73138,48567,14878,Manipur,81,73057,88016,136760,73138,2781,220,3,17/03/2021
32896,102116,69215,50010,Manipur,0,152126,152126,102116,102116,11700,110,5,17/04/2021
73,169,96,0,Manipur,0,169,169,72196,169,40,15,0,18/01/2021
20049,33302,13252,801,Manipur,19,33283,34103,121766,33302,834,177,1,18/02/2021
24635,73787,49149,15968,Manipur,82,73705,89755,137074,73787,2929,220,3,18/03/2021
33181,102983,69797,50121,Manipur,0,153104,153104,102983,102983,8690,80,5,18/04/2021
104,267,163,0,Manipur,0,267,267,77819,267,58,16,0,19/01/2021
21279,36102,14822,1108,Manipur,28,36074,37210,126871,36102,906,179,1,19/02/2021
24823,74627,49801,17735,Manipur,86,74541,92362,137514,74627,3050,221,3,19/03/2021
34626,106513,71882,51199,Manipur,0,157712,157712,106513,106513,12290,118,5,19/04/2021
180,426,246,0,Manipur,0,426,426,82613,426,61,16,0,20/01/2021
21615,37523,15907,1354,Manipur,29,37494,38877,126874,37523,935,182,1,20/02/2021
25150,75596,50443,19628,Manipur,87,75509,95224,138127,75596,3117,221,3,20/03/2021
36068,109878,73805,52226,Manipur,0,162104,162104,109878,109878,11400,108,5,20/04/2021
180,426,246,0,Manipur,0,426,426,82793,426,73,17,0,21/01/2021
21798,37813,16014,1366,Manipur,29,37784,39179,126914,37813,964,184,1,21/02/2021
25206,75794,50585,19783,Manipur,87,75707,95577,138232,75794,3174,222,3,21/03/2021
38069,114345,76271,53174,Manipur,0,167519,167519,114345,114345,12150,114,5,21/04/2021
313,693,380,0,Manipur,0,693,693,83551,693,81,19,0,22/01/2021
25487,76701,51211,21688,Manipur,89,76612,98389,138832,76701,3286,222,3,22/03/2021
39438,117450,78007,54290,Manipur,0,171740,171740,117450,117450,11000,103,5,22/04/2021
535,1097,562,0,Manipur,0,1097,1097,84623,1097,83,19,0,23/01/2021
25651,77827,52173,23341,Manipur,89,77738,101168,139412,77827,3417,222,3,23/03/2021
40089,119440,79346,54809,Manipur,0,174249,174249,119440,119440,8800,84,5,23/04/2021
540,1109,569,0,Manipur,0,1109,1109,85041,1109,83,19,0,24/01/2021
25956,78852,52893,25100,Manipur,89,78763,103952,140060,78852,3545,222,3,24/03/2021
42183,124435,82247,55765,Manipur,0,180200,180200,124435,124435,10890,97,5,24/04/2021
649,1319,670,0,Manipur,0,1319,1319,86877,1319,83,19,0,25/01/2021
26122,79530,53405,26578,Manipur,90,79440,106108,140393,79530,3650,222,3,25/03/2021
43160,126565,83400,55981,Manipur,0,182546,182546,126565,126565,3600,34,5,25/04/2021
651,1328,677,0,Manipur,0,1328,1328,86920,1328,89,19,0,26/01/2021
26446,80549,54100,28440,Manipur,92,80457,108989,141014,80549,3753,223,3,26/03/2021
46963,134935,87966,57217,Manipur,0,192152,192152,134935,134935,11250,104,6,26/04/2021
996,1873,877,0,Manipur,0,1873,1873,87225,1873,95,19,0,27/01/2021
26713,81431,54715,29753,Manipur,92,81339,111184,141573,81431,3818,224,3,27/03/2021
50606,142612,91999,58062,Manipur,0,200674,200674,142612,142612,10200,93,7,27/04/2021
1016,1909,893,0,Manipur,0,1909,1909,87310,1909,101,21,0,28/01/2021
22094,48312,26217,2253,Manipur,39,48273,50565,126992,48312,1171,197,1,28/02/2021
26713,81454,54738,29851,Manipur,92,81362,111305,141577,81454,3825,224,3,28/03/2021
1281,2394,1113,0,Manipur,0,2394,2394,87926,2394,108,22,0,29/01/2021
1539,2933,1394,0,Manipur,0,2933,2933,88538,2933,110,23,0,30/01/2021
26766,81950,55181,30318,Manipur,93,81857,112268,141867,81950,3874,224,3,30/03/2021
1547,2947,1400,0,Manipur,0,2947,2947,89051,2947,113,23,0,31/01/2021
26819,82317,55495,30979,Manipur,96,82221,113296,142126,82317,3900,224,3,31/03/2021
2170,3317,1147,0,Meghalaya,0,3317,3317,51834,3317,144,53,0,01/02/2021
37583,84742,47151,34118,Meghalaya,196,84546,118860,115959,84742,10053,467,8,01/04/2021
2243,3451,1208,0,Meghalaya,0,3451,3451,51979,3451,149,55,0,02/02/2021
17489,42313,24820,4022,Meghalaya,147,42166,46335,76471,42313,2178,245,4,02/03/2021
37914,85308,47386,34275,Meghalaya,198,85110,119583,116410,85308,10159,487,8,02/04/2021
2312,3565,1253,0,Meghalaya,0,3565,3565,52307,3565,172,67,0,03/02/2021
17999,43856,25853,4247,Meghalaya,147,43709,48103,77759,43856,3094,245,4,03/03/2021
38387,86257,47862,34539,Meghalaya,210,86047,120796,117356,86257,10183,489,8,03/04/2021
2753,4216,1463,0,Meghalaya,0,4216,4216,52637,4216,198,86,0,04/02/2021
18691,45315,26619,4591,Meghalaya,147,45168,49906,79097,45315,3418,248,5,04/03/2021
38825,85528,46695,32923,Meghalaya,0,118451,118451,85528,85528,4300,42,8,04/04/2021
3241,4933,1692,0,Meghalaya,0,4933,4933,52851,4933,211,95,0,05/02/2021
19205,46494,27284,5200,Meghalaya,149,46345,51694,80111,46494,3473,249,5,05/03/2021
39795,87294,47491,33631,Meghalaya,0,120925,120925,87294,87294,21350,201,8,05/04/2021
3785,5585,1800,0,Meghalaya,0,5585,5585,53501,5585,222,103,0,06/02/2021
19501,47342,27836,5508,Meghalaya,153,47189,52850,80739,47342,3542,249,5,06/03/2021
40586,88683,48089,34221,Meghalaya,0,122904,122904,88683,88683,22270,206,8,06/04/2021
3785,5585,1800,0,Meghalaya,0,5585,5585,53877,5585,251,117,0,07/02/2021
43317,93455,50130,35657,Meghalaya,0,129112,129112,93455,93455,19950,190,8,07/04/2021
4337,6394,2054,0,Meghalaya,0,6394,6394,54182,6394,293,127,3,08/02/2021
20400,49452,29047,6249,Meghalaya,158,49294,55701,82650,49452,4058,292,5,08/03/2021
45969,98204,52226,36985,Meghalaya,0,135189,135189,98204,98204,23020,212,9,08/04/2021
5338,7806,2465,0,Meghalaya,0,7806,7806,54952,7806,317,139,3,09/02/2021
21359,51314,29950,7144,Meghalaya,161,51153,58458,84380,51314,4690,304,5,09/03/2021
47608,101170,53553,37957,Meghalaya,0,139127,139127,101170,101170,19650,187,9,09/04/2021
5863,8557,2691,0,Meghalaya,0,8557,8557,56073,8557,359,152,3,10/02/2021
22233,52966,30728,7976,Meghalaya,161,52805,60942,85891,52966,5286,311,5,10/03/2021
48585,103084,54490,38242,Meghalaya,0,141326,141326,103084,103084,10100,92,9,10/04/2021
7171,10420,3246,0,Meghalaya,0,10420,10420,57029,10420,386,160,3,11/02/2021
23425,55125,31694,9141,Meghalaya,165,54960,64266,87951,55125,5434,316,6,11/03/2021
49051,104057,54997,38388,Meghalaya,0,142445,142445,104057,104057,8350,73,9,11/04/2021
7739,11614,3872,0,Meghalaya,3,11611,11614,57777,11614,410,168,3,12/02/2021
24055,56575,32514,10146,Meghalaya,166,56409,66721,89314,56575,5845,320,6,12/03/2021
50814,107560,56737,39038,Meghalaya,0,146598,146598,107560,107560,21250,190,9,12/04/2021
8526,12905,4375,91,Meghalaya,3,12902,12996,58654,12905,433,172,4,13/02/2021
24493,57654,33155,10974,Meghalaya,167,57487,68628,90317,57654,6015,325,6,13/03/2021
53468,112619,59142,40206,Meghalaya,0,152825,152825,112619,112619,31150,278,9,13/04/2021
8526,12906,4376,91,Meghalaya,4,12902,12997,58720,12906,503,187,4,14/02/2021
24499,57660,33155,10978,Meghalaya,167,57493,68638,90321,57660,6205,330,6,14/03/2021
55435,116428,60984,41065,Meghalaya,0,157493,157493,116428,116428,29900,278,9,14/04/2021
9477,15019,5538,251,Meghalaya,5,15014,15270,60910,15019,576,194,4,15/02/2021
25320,59513,34187,12222,Meghalaya,167,59346,71735,92101,59513,6360,331,6,15/03/2021
57821,120703,62871,42539,Meghalaya,0,163242,163242,120703,120703,33900,282,11,15/04/2021
79,102,23,0,Meghalaya,0,102,102,45503,102,12,10,0,16/01/2021
10678,17479,6797,490,Meghalaya,5,17474,17969,63801,17479,689,204,4,16/02/2021
26350,61696,35340,14181,Meghalaya,169,61527,75877,94125,61696,6494,332,6,16/03/2021
59715,124078,64352,43455,Meghalaya,0,167533,167533,124078,124078,26150,220,11,16/04/2021
79,102,23,0,Meghalaya,0,102,102,45603,102,12,10,0,17/01/2021
12614,21153,8535,811,Meghalaya,5,21148,21964,70008,21153,784,213,4,17/02/2021
27219,63468,36243,15956,Meghalaya,169,63299,79424,95816,63468,6612,334,6,17/03/2021
60542,125525,64971,43950,Meghalaya,0,169475,169475,125525,125525,11550,101,12,17/04/2021
44,58,14,0,Meghalaya,0,58,58,41178,58,44,13,0,18/01/2021
13413,23995,10578,1236,Meghalaya,6,23989,25231,65381,23995,904,220,4,18/02/2021
28107,65428,37315,18226,Meghalaya,173,65255,83654,97673,65428,6764,338,6,18/03/2021
60587,125611,65012,43967,Meghalaya,0,169578,169578,125611,125611,9200,91,12,18/04/2021
127,170,43,0,Meghalaya,0,170,170,44141,170,53,17,0,19/01/2021
14917,27429,12508,1599,Meghalaya,9,27420,29028,76366,27429,1012,227,4,19/02/2021
28869,67130,38255,20350,Meghalaya,173,66957,87480,99205,67130,7154,340,6,19/03/2021
62612,129164,66540,45558,Meghalaya,0,174722,174722,129164,129164,27000,256,12,19/04/2021
137,189,52,0,Meghalaya,0,189,189,44658,189,66,21,0,20/01/2021
15315,29428,14109,1683,Meghalaya,49,29379,31111,76888,29428,1058,232,4,20/02/2021
29153,67944,38784,21510,Meghalaya,174,67770,89454,99898,67944,7303,345,7,20/03/2021
65059,133716,68644,46932,Meghalaya,0,180648,180648,133716,133716,29000,260,13,20/04/2021
246,380,134,0,Meghalaya,0,380,380,46500,380,85,25,0,21/01/2021
15339,29459,14116,1683,Meghalaya,49,29410,31142,76963,29459,1162,237,4,21/02/2021
29173,67981,38801,21530,Meghalaya,174,67807,89511,99930,67981,7600,349,7,21/03/2021
66986,137342,70343,47887,Meghalaya,0,185229,185229,137342,137342,28000,259,13,21/04/2021
346,525,179,0,Meghalaya,0,525,525,47769,525,90,28,0,22/01/2021
15645,31976,16327,2080,Meghalaya,101,31875,34056,77002,31976,1244,239,4,22/02/2021
29989,69789,39793,23744,Meghalaya,176,69613,93533,101647,69789,8040,355,7,22/03/2021
70905,144721,73803,49787,Meghalaya,0,194508,194508,144721,144721,37050,316,13,22/04/2021
490,709,219,0,Meghalaya,0,709,709,48995,709,93,30,0,23/01/2021
31085,72103,41011,26588,Meghalaya,180,71923,98691,103793,72103,8230,374,7,23/03/2021
74479,151994,77501,51229,Meghalaya,0,203223,203223,151994,151994,35250,279,14,23/04/2021
493,713,220,0,Meghalaya,0,713,713,49920,713,98,32,0,24/01/2021
16225,36656,20427,2472,Meghalaya,131,36525,39128,77008,36656,1486,243,4,24/02/2021
31821,73671,41843,28176,Meghalaya,181,73490,101847,105265,73671,8350,385,7,24/03/2021
77418,157665,80233,51857,Meghalaya,0,209522,209522,157665,157665,35430,212,14,24/04/2021
840,1249,409,0,Meghalaya,0,1249,1249,50424,1249,100,32,0,25/01/2021
32960,76127,43160,30375,Meghalaya,181,75946,106502,107563,76127,8520,392,7,25/03/2021
77627,158278,80637,51894,Meghalaya,0,210172,210172,158278,158278,6100,48,14,25/04/2021
845,1256,411,0,Meghalaya,0,1256,1256,50591,1256,110,38,0,26/01/2021
16870,40214,23340,3606,Meghalaya,147,40067,43820,74773,40214,1609,245,4,26/02/2021
33712,77621,43901,31320,Meghalaya,182,77439,108941,108970,77621,8646,399,8,26/03/2021
84369,171659,87275,53679,Meghalaya,0,225338,225338,171659,171659,57600,421,15,26/04/2021
1357,1964,607,0,Meghalaya,0,1964,1964,50807,1964,126,44,0,27/01/2021
33955,78104,44141,31510,Meghalaya,182,77922,109614,109394,78104,8733,401,8,27/03/2021
92508,187409,94885,55163,Meghalaya,0,242572,242572,187409,187409,69390,493,16,27/04/2021
1761,2609,848,0,Meghalaya,0,2609,2609,51157,2609,133,47,0,28/01/2021
33958,78116,44150,31512,Meghalaya,182,77934,109628,109406,78116,8885,409,8,28/03/2021
1973,2925,952,0,Meghalaya,0,2925,2925,51376,2925,136,50,0,29/01/2021
34593,79195,44594,31764,Meghalaya,182,79013,110959,110470,79195,8945,411,8,29/03/2021
2034,3070,1036,0,Meghalaya,0,3070,3070,51593,3070,137,50,0,30/01/2021
35410,80759,45341,32741,Meghalaya,182,80577,113500,111976,80759,9181,423,8,30/03/2021
2039,3076,1037,0,Meghalaya,0,3076,3076,51705,3076,140,52,0,31/01/2021
35966,81801,45827,33346,Meghalaya,195,81606,115147,112976,81801,9685,446,8,31/03/2021
5995,8462,2467,0,Mizoram,0,8462,8462,39420,8462,285,121,0,01/02/2021
22889,56798,33907,14830,Mizoram,24,56774,71628,76397,56798,1799,309,2,01/04/2021
5995,8462,2467,0,Mizoram,0,8462,8462,39445,8462,287,123,0,02/02/2021
10238,25609,15371,7795,Mizoram,6,25603,33404,46630,25609,973,255,0,02/03/2021
22970,56956,33984,14892,Mizoram,26,56930,71848,76508,56956,1804,309,2,02/04/2021
6047,8525,2478,0,Mizoram,0,8525,8525,39447,8525,287,123,0,03/02/2021
11322,28887,17565,8889,Mizoram,6,28881,37776,49704,28887,1080,258,0,03/03/2021
22973,57022,34047,14930,Mizoram,30,56992,71952,76564,57022,1816,309,2,03/04/2021
6087,8583,2496,0,Mizoram,0,8583,8583,39476,8583,303,126,0,04/02/2021
12381,31897,19516,9052,Mizoram,9,31888,40949,52146,31897,1149,262,0,04/03/2021
22948,56489,33539,14615,Mizoram,0,71104,71104,56489,56489,2400,19,2,04/04/2021
6447,9110,2663,0,Mizoram,0,9110,9110,39650,9110,318,127,0,05/02/2021
12681,32860,20179,9113,Mizoram,10,32850,41973,52840,32860,1185,265,0,05/03/2021
23443,57385,33940,15536,Mizoram,0,72921,72921,57385,57385,7620,41,2,05/04/2021
6713,9470,2757,0,Mizoram,1,9469,9470,40026,9470,318,127,0,06/02/2021
12957,34027,21069,9175,Mizoram,10,34017,43202,53897,34027,1224,268,1,06/03/2021
24032,58483,34449,16209,Mizoram,0,74692,74692,58483,58483,11450,46,2,06/04/2021
6715,9476,2761,0,Mizoram,1,9475,9476,40324,9476,318,127,0,07/02/2021
12985,34115,21129,9180,Mizoram,10,34105,43295,53978,34115,1248,270,1,07/03/2021
26755,63319,36562,18076,Mizoram,0,81395,81395,63319,63319,6500,30,2,07/04/2021
6727,9492,2765,0,Mizoram,1,9491,9492,40329,9492,322,128,0,08/02/2021
28993,67481,38486,19506,Mizoram,0,86987,86987,67481,67481,6800,29,2,08/04/2021
6774,9603,2829,0,Mizoram,1,9602,9603,40452,9603,325,130,0,09/02/2021
14938,38450,23511,9366,Mizoram,13,38437,47816,58384,38450,1375,285,1,09/03/2021
31153,71502,40347,21136,Mizoram,0,92638,92638,71502,71502,10850,39,2,09/04/2021
6809,9642,2833,0,Mizoram,1,9641,9642,40541,9642,330,131,0,10/02/2021
16599,42160,25560,9780,Mizoram,13,42147,51940,62141,42160,1433,289,1,10/03/2021
32290,73602,41310,21583,Mizoram,0,95185,95185,73602,73602,4100,19,2,10/04/2021
6809,9642,2833,0,Mizoram,1,9641,9642,40542,9642,339,136,0,11/02/2021
17511,44023,26511,9974,Mizoram,13,44010,53997,63884,44023,1455,290,1,11/03/2021
32438,73831,41391,21975,Mizoram,0,95806,95806,73831,73831,2270,11,2,11/04/2021
6889,9941,3052,0,Mizoram,1,9940,9941,41000,9941,359,142,0,12/02/2021
18079,45256,27176,10037,Mizoram,13,45243,55293,65052,45256,1466,291,1,12/03/2021
36171,80821,44647,23864,Mizoram,0,104685,104685,80821,80821,13550,54,3,12/04/2021
6975,10179,3204,75,Mizoram,1,10178,10254,41122,10179,371,146,0,13/02/2021
18340,45753,27412,10114,Mizoram,13,45740,55867,65536,45753,1476,292,1,13/03/2021
39598,87233,47632,25745,Mizoram,0,112978,112978,87233,87233,11450,51,3,13/04/2021
6975,10365,3390,75,Mizoram,1,10364,10440,41130,10365,374,146,0,14/02/2021
18364,45795,27430,10182,Mizoram,13,45782,55977,65597,45795,1504,294,1,14/03/2021
43613,94676,51060,28385,Mizoram,0,123061,123061,94676,94676,11200,50,3,14/04/2021
7174,11167,3993,227,Mizoram,2,11165,11394,41643,11167,383,148,0,15/02/2021
19201,47411,28209,10570,Mizoram,13,47398,57981,67174,47411,1530,296,1,15/03/2021
49384,105054,55665,30301,Mizoram,0,135355,135355,105054,105054,12850,54,5,15/04/2021
68,105,37,0,Mizoram,0,105,105,10515,105,6,5,0,16/01/2021
7174,11175,4001,227,Mizoram,2,11173,11402,41645,11175,412,155,0,16/02/2021
20520,50024,29503,10688,Mizoram,14,50010,60712,69758,50024,1547,296,1,16/03/2021
56195,117031,60831,31042,Mizoram,0,148073,148073,117031,117031,12920,53,5,16/04/2021
68,105,37,0,Mizoram,0,105,105,11310,105,11,6,0,17/01/2021
7516,12174,4658,581,Mizoram,2,12172,12755,42793,12174,450,157,0,17/02/2021
20943,50880,29936,10873,Mizoram,14,50866,61753,70589,50880,1568,297,1,17/03/2021
59177,122168,62986,31688,Mizoram,0,153856,153856,122168,122168,5900,27,5,17/04/2021
64,98,34,0,Mizoram,0,98,98,10920,98,38,9,0,18/01/2021
7609,12914,5305,1391,Mizoram,4,12910,14305,42330,12914,484,160,0,18/02/2021
21174,51502,30327,11370,Mizoram,14,51488,62872,71204,51502,1601,297,1,18/03/2021
59280,122419,63134,31764,Mizoram,0,154183,154183,122419,122419,450,4,5,18/04/2021
157,259,102,0,Mizoram,0,259,259,12750,259,58,13,0,19/01/2021
8199,14481,6282,2191,Mizoram,4,14477,16672,43351,14481,504,172,0,19/02/2021
21307,51947,30639,11927,Mizoram,14,51933,63874,71636,51947,1617,297,1,19/03/2021
64362,131756,67388,33045,Mizoram,0,164801,164801,131756,131756,13650,59,6,19/04/2021
170,291,121,0,Mizoram,0,291,291,12856,291,81,22,0,20/01/2021
21533,52492,30958,12131,Mizoram,15,52477,64623,72180,52492,1623,297,1,20/03/2021
68547,139758,71205,34605,Mizoram,0,174363,174363,139758,139758,19650,57,6,20/04/2021
404,632,228,0,Mizoram,0,632,632,18008,632,123,45,0,21/01/2021
21534,52497,30962,12134,Mizoram,15,52482,64631,72185,52497,1629,297,1,21/03/2021
70818,144492,73668,36298,Mizoram,0,180790,180790,144492,144492,16200,49,6,21/04/2021
1033,1494,461,0,Mizoram,0,1494,1494,18567,1494,136,51,0,22/01/2021
21612,52967,31354,12441,Mizoram,15,52952,65408,72626,52967,1656,298,1,22/03/2021
76883,156035,79146,38027,Mizoram,0,194062,194062,156035,156035,20720,65,6,22/04/2021
1326,1870,544,0,Mizoram,0,1870,1870,23839,1870,140,51,0,23/01/2021
21787,53593,31805,12861,Mizoram,16,53577,66454,73232,53593,1669,301,1,23/03/2021
82491,166665,84167,39512,Mizoram,0,206177,206177,166665,166665,17500,56,7,23/04/2021
1372,1945,573,0,Mizoram,0,1945,1945,31704,1945,160,58,0,24/01/2021
21879,53901,32021,12987,Mizoram,17,53884,66888,73536,53901,1688,303,1,24/03/2021
84563,170765,86195,40345,Mizoram,0,211110,211110,170765,170765,8040,29,7,24/04/2021
2127,3087,960,0,Mizoram,0,3087,3087,36936,3087,172,61,0,25/01/2021
22101,54583,32481,13153,Mizoram,18,54565,67736,74208,54583,1710,305,1,25/03/2021
84610,170856,86239,40364,Mizoram,0,211220,211220,170856,170856,550,4,7,25/04/2021
2148,3115,967,0,Mizoram,0,3115,3115,37037,3115,192,73,0,26/01/2021
22360,55431,33069,13574,Mizoram,18,55413,69005,75071,55431,1714,305,2,26/03/2021
90006,181115,91102,42282,Mizoram,0,223397,223397,181115,181115,16362,57,7,26/04/2021
3270,4782,1512,0,Mizoram,0,4782,4782,37707,4782,221,97,0,27/01/2021
22384,55497,33111,13591,Mizoram,18,55479,69088,75098,55497,1716,305,2,27/03/2021
95359,191344,95978,43697,Mizoram,0,235041,235041,191344,191344,25810,65,7,27/04/2021
3694,5391,1697,0,Mizoram,0,5391,5391,38283,5391,247,110,0,28/01/2021
4958,7065,2107,0,Mizoram,0,7065,7065,39013,7065,260,115,0,29/01/2021
22386,55508,33120,13667,Mizoram,18,55490,69175,75108,55508,1735,307,2,29/03/2021
5645,7977,2332,0,Mizoram,0,7977,7977,39237,7977,268,115,0,30/01/2021
22471,55781,33308,13963,Mizoram,18,55763,69744,75350,55781,1755,307,2,30/03/2021
22510,55961,33449,14220,Mizoram,23,55938,70181,75521,55961,1772,307,2,31/03/2021
2194,3535,1340,0,Nagaland,0,3535,3535,67759,3535,219,118,1,01/02/2021
17907,60589,42678,23178,Nagaland,417,60172,83767,103021,60589,3330,230,4,01/04/2021
2235,3630,1394,0,Nagaland,0,3630,3630,67886,3630,230,119,1,02/02/2021
7152,28489,21336,5177,Nagaland,259,28230,33666,75149,28489,842,199,1,02/03/2021
18023,60875,42848,23256,Nagaland,417,60458,84131,103247,60875,3347,231,4,02/04/2021
2346,3781,1434,0,Nagaland,0,3781,3781,67954,3781,237,121,1,03/02/2021
7395,30205,22809,5273,Nagaland,295,29910,35478,75946,30205,926,199,1,03/03/2021
18037,60964,42923,23395,Nagaland,417,60547,84359,103313,60964,3379,231,4,03/04/2021
2446,3958,1511,0,Nagaland,0,3958,3958,68016,3958,241,123,1,04/02/2021
7636,31007,23370,5428,Nagaland,312,30695,36435,76528,31007,1008,199,1,04/03/2021
18131,60027,41892,22546,Nagaland,0,82573,82573,60027,60027,3700,27,4,04/04/2021
2491,4068,1576,0,Nagaland,0,4068,4068,68114,4068,243,124,1,05/02/2021
7683,31300,23616,5538,Nagaland,334,30966,36838,76672,31300,1081,200,1,05/03/2021
18916,61890,42970,23366,Nagaland,0,85256,85256,61890,61890,9950,87,4,05/04/2021
2509,4092,1582,0,Nagaland,0,4092,4092,68320,4092,248,126,1,06/02/2021
7719,31900,24180,5549,Nagaland,350,31550,37449,76986,31900,1136,200,1,06/03/2021
19740,63628,43884,23824,Nagaland,0,87452,87452,63628,63628,12000,94,4,06/04/2021
2509,4093,1583,0,Nagaland,0,4093,4093,68577,4093,263,133,1,07/02/2021
7732,31985,24252,5549,Nagaland,350,31635,37534,77042,31985,1234,203,1,07/03/2021
22282,68608,46320,24749,Nagaland,0,93357,93357,68608,68608,11400,93,6,07/04/2021
2596,4502,1905,0,Nagaland,0,4502,4502,68788,4502,289,139,1,08/02/2021
8349,33821,25471,5881,Nagaland,351,33470,39702,78622,33821,1313,204,1,08/03/2021
24159,72338,48173,25524,Nagaland,0,97862,97862,72338,72338,10650,86,6,08/04/2021
2730,5380,2649,0,Nagaland,0,5380,5380,69092,5380,302,144,1,09/02/2021
8640,34811,26170,6226,Nagaland,359,34452,41037,79387,34811,1350,204,1,09/03/2021
25194,74498,49298,26035,Nagaland,0,100533,100533,74498,74498,6850,57,6,09/04/2021
2806,6606,3799,0,Nagaland,0,6606,6606,69787,6606,326,148,1,10/02/2021
9169,36406,27236,7023,Nagaland,364,36042,43429,80838,36406,1439,206,1,10/03/2021
25550,75334,49778,26146,Nagaland,0,101480,101480,75334,75334,3950,28,6,10/04/2021
2894,7779,4884,0,Nagaland,0,7779,7779,70280,7779,341,153,1,11/02/2021
9651,38178,28526,8223,Nagaland,373,37805,46401,82305,38178,1529,206,1,11/03/2021
27640,79469,51823,26368,Nagaland,0,105837,105837,79469,79469,12150,94,6,11/04/2021
2940,8510,5569,0,Nagaland,0,8510,8510,70373,8510,352,154,1,12/02/2021
9767,38697,28929,8757,Nagaland,378,38319,47454,82703,38697,1562,206,1,12/03/2021
31079,86333,55248,27600,Nagaland,0,113933,113933,86333,86333,14900,125,6,12/04/2021
2946,9041,6094,0,Nagaland,0,9041,9041,70887,9041,361,157,1,13/02/2021
9777,38871,29093,9116,Nagaland,378,38493,47987,82833,38871,1595,206,1,13/03/2021
34123,92497,58368,28351,Nagaland,0,120848,120848,92497,92497,16660,141,6,13/04/2021
3026,9175,6148,123,Nagaland,0,9175,9298,71228,9175,382,164,1,14/02/2021
9777,39012,29234,9244,Nagaland,378,38634,48256,82973,39012,1668,209,1,14/03/2021
37347,98957,61604,29173,Nagaland,0,128130,128130,98957,98957,16650,136,6,14/04/2021
3323,11064,7740,310,Nagaland,2,11062,11374,72363,11064,411,169,1,15/02/2021
10290,40844,30553,10695,Nagaland,378,40466,51539,84725,40844,1923,212,1,15/03/2021
39012,102973,63955,30077,Nagaland,0,133050,133050,102973,102973,13750,106,6,15/04/2021
44,94,50,0,Nagaland,0,94,94,34628,94,9,9,0,16/01/2021
3960,12836,8875,1019,Nagaland,2,12834,13855,72925,12836,457,173,1,16/02/2021
10879,42554,31674,12032,Nagaland,378,42176,54586,86212,42554,2053,216,1,16/03/2021
40983,107176,66187,30445,Nagaland,0,137621,137621,107176,107176,11500,85,6,16/04/2021
44,94,50,0,Nagaland,0,94,94,35510,94,36,21,0,17/01/2021
4391,14478,10086,1419,Nagaland,2,14476,15897,73586,14478,482,176,1,17/02/2021
11363,43885,32521,12827,Nagaland,378,43507,56712,87416,43885,2216,221,1,17/03/2021
41563,108525,66955,30527,Nagaland,0,139052,139052,108525,108525,4800,36,7,17/04/2021
182,315,133,0,Nagaland,0,315,315,37236,315,86,53,0,18/01/2021
4396,15776,11380,2245,Nagaland,2,15774,18021,73566,15776,521,181,0,18/02/2021
11913,45208,33294,14014,Nagaland,378,44830,59222,88645,45208,2316,223,1,18/03/2021
42059,109571,67505,30536,Nagaland,0,140107,140107,109571,109571,8050,73,7,18/04/2021
409,649,240,0,Nagaland,0,649,649,38386,649,120,78,0,19/01/2021
5499,18981,13481,2949,Nagaland,4,18977,21930,74487,18981,551,184,1,19/02/2021
12128,46054,33924,14660,Nagaland,382,45672,60714,89395,46054,2356,223,2,19/03/2021
45262,117085,71815,31597,Nagaland,0,148682,148682,117085,117085,20800,164,8,19/04/2021
676,1070,394,0,Nagaland,0,1070,1070,38977,1070,159,101,0,20/01/2021
5732,19801,14068,3438,Nagaland,4,19797,23239,74495,19801,571,185,1,20/02/2021
12243,46378,34133,15017,Nagaland,384,45994,61395,89671,46378,2381,224,2,20/03/2021
47779,122616,74828,32579,Nagaland,0,155195,155195,122616,122616,19000,153,9,20/04/2021
806,1267,461,0,Nagaland,0,1267,1267,40308,1267,169,109,0,21/01/2021
5733,19895,14161,3438,Nagaland,4,19891,23333,74502,19895,591,188,1,21/02/2021
12320,46547,34225,15062,Nagaland,384,46163,61609,89839,46547,2491,226,2,21/03/2021
50737,128948,78202,33467,Nagaland,0,162415,162415,128948,128948,19050,143,9,21/04/2021
1000,1563,563,0,Nagaland,0,1563,1563,49681,1563,171,109,0,22/01/2021
13026,48842,35814,17284,Nagaland,389,48453,66126,92025,48842,2564,227,2,22/03/2021
53552,134903,81342,34316,Nagaland,0,169219,169219,134903,134903,17650,132,9,22/04/2021
1006,1574,568,0,Nagaland,0,1574,1574,59282,1574,179,111,0,23/01/2021
14130,51548,37414,18814,Nagaland,392,51156,70362,94434,51548,2651,227,4,23/03/2021
54389,136694,82296,34908,Nagaland,0,171602,171602,136694,136694,10450,75,9,23/04/2021
1010,1583,573,0,Nagaland,0,1583,1583,61753,1583,193,114,0,24/01/2021
14661,52821,38156,19790,Nagaland,394,52427,72611,95622,52821,2705,227,4,24/03/2021
54612,137232,82611,35047,Nagaland,0,172279,172279,137232,137232,3150,20,9,24/04/2021
1590,2447,857,0,Nagaland,0,2447,2447,65436,2447,193,114,0,25/01/2021
15213,54235,39018,20687,Nagaland,394,53841,74922,96965,54235,2800,227,4,25/03/2021
54779,137582,82794,35067,Nagaland,0,172649,172649,137582,137582,2450,17,9,25/04/2021
1621,2491,870,0,Nagaland,0,2491,2491,65512,2491,214,118,0,26/01/2021
15422,54718,39292,20889,Nagaland,400,54318,75607,97452,54718,2816,227,4,26/03/2021
56674,141446,84763,36752,Nagaland,0,178198,178198,141446,141446,14550,110,9,26/04/2021
2101,3371,1269,0,Nagaland,0,3371,3371,66003,3371,215,118,1,27/01/2021
15479,54875,39392,21016,Nagaland,401,54474,75891,97576,54875,2849,227,4,27/03/2021
58627,145555,86919,37646,Nagaland,0,183201,183201,145555,145555,17700,137,9,27/04/2021
2168,3485,1316,0,Nagaland,0,3485,3485,66425,3485,215,118,1,28/01/2021
6889,27408,20518,5000,Nagaland,229,27179,32408,74503,27408,741,196,1,28/02/2021
15479,54879,39396,21018,Nagaland,401,54478,75897,97579,54879,2898,227,4,28/03/2021
2186,3509,1322,0,Nagaland,0,3509,3509,66744,3509,215,118,1,29/01/2021
15544,54987,39439,21022,Nagaland,401,54586,76009,97703,54987,3050,228,4,29/03/2021
2189,3529,1339,0,Nagaland,0,3529,3529,67519,3529,215,118,1,30/01/2021
16553,57482,40925,22149,Nagaland,407,57075,79631,100090,57482,3109,229,4,30/03/2021
2190,3530,1339,0,Nagaland,0,3530,3530,67626,3530,216,118,1,31/01/2021
17226,58979,41749,22718,Nagaland,413,58566,81697,101396,58979,3261,230,4,31/03/2021
119102,159914,40804,0,Odisha,10316,149598,159914,446128,159914,2606,718,8,01/02/2021
937009,1978487,1041267,373152,Odisha,111220,1867267,2351639,2156207,1978487,56204,2502,211,01/04/2021
119759,161078,41311,0,Odisha,11119,149959,161078,446621,161078,2749,753,8,02/02/2021
250010,469228,219169,139725,Odisha,38602,430626,608953,604226,469228,9297,1423,49,02/03/2021
1031957,2172410,1140217,384161,Odisha,117340,2055070,2556571,2367113,2172410,59383,2571,236,02/04/2021
123044,165753,42700,0,Odisha,11851,153902,165753,450389,165753,2976,794,9,03/02/2021
259536,493470,233881,142878,Odisha,40722,452748,636348,628551,493470,11532,1472,53,03/03/2021
1118820,2346578,1227503,393453,Odisha,122510,2224068,2740031,2557144,2346578,62251,2651,255,03/04/2021
140115,186187,46063,0,Odisha,12225,173962,186187,461385,186187,3130,846,9,04/02/2021
273124,525756,252577,152414,Odisha,43039,482717,678170,662859,525756,13532,1485,55,04/03/2021
1272623,2663583,1390656,405771,Odisha,184918,2884436,3069354,2663583,2663583,249034,1301,304,04/04/2021
143573,190943,47344,0,Odisha,12710,178233,190943,465585,190943,3357,999,26,05/02/2021
282553,548018,265410,157089,Odisha,45134,502884,705107,686099,548018,14985,1495,55,05/03/2021
1337385,2793731,1456017,414521,Odisha,191897,3016355,3208252,2793731,2793731,272239,1536,329,05/04/2021
155685,220401,64690,0,Odisha,13430,206971,220401,478970,220401,3606,1082,26,06/02/2021
296212,579310,283026,165255,Odisha,48188,531122,744565,717285,579310,17147,1533,72,06/03/2021
1417014,2952028,1534662,423879,Odisha,199932,3175975,3375907,2952028,2952028,225961,1297,352,06/04/2021
156864,223714,66824,0,Odisha,13430,210284,223714,484361,223714,3909,1149,26,07/02/2021
297960,582986,284954,166091,Odisha,48395,534591,749077,720130,582986,18147,1542,72,07/03/2021
1504028,3129687,1625286,436165,Odisha,213800,3352052,3565852,3129687,3129687,170998,1025,373,07/04/2021
168112,255650,87507,0,Odisha,15216,240434,255650,495626,255650,4124,1173,31,08/02/2021
317098,628602,311428,191726,Odisha,52292,576310,820328,768377,628602,19210,1566,76,08/03/2021
1592685,3311254,1718161,451846,Odisha,229599,3533501,3763100,3311254,3311254,210060,1214,408,08/04/2021
175862,282491,106597,0,Odisha,17942,264549,282491,508948,282491,4406,1214,32,09/02/2021
335724,672142,336339,213208,Odisha,55093,617049,885350,809441,672142,19850,1576,79,09/03/2021
1676650,3480440,1803350,470074,Odisha,242664,3707850,3950514,3480440,3480440,272626,1502,440,09/04/2021
189872,316166,126258,0,Odisha,20655,295511,316166,522739,316166,4630,1250,36,10/02/2021
347964,702359,354312,229157,Odisha,57586,644773,931516,838848,702359,20621,1582,83,10/03/2021
1738339,3604413,1865611,483546,Odisha,255805,3832154,4087959,3604413,3604413,217921,1195,463,10/04/2021
194094,334559,140425,0,Odisha,23098,311461,334559,534146,334559,4864,1266,40,11/02/2021
350184,707985,357718,231884,Odisha,58950,649035,939869,843853,707985,21369,1615,83,11/03/2021
1793847,3715949,1921614,494670,Odisha,264397,3946222,4210619,3715949,3715949,236114,1275,488,11/04/2021
198925,350417,151452,0,Odisha,25260,325157,350417,544783,350417,5079,1269,40,12/02/2021
369806,754606,384713,254966,Odisha,61113,693493,1009572,890615,754606,23216,1669,87,12/03/2021
1855933,3839733,1983292,512058,Odisha,273915,4077876,4351791,3839733,3839733,252939,1388,508,12/04/2021
202655,360203,157507,3,Odisha,28009,332194,360206,554629,360203,5218,1274,41,13/02/2021
390328,801272,410856,269262,Odisha,64220,737052,1070534,937168,801272,24912,1737,88,13/03/2021
1894320,3919536,2024693,521861,Odisha,281385,4160012,4441397,3919536,3919536,212850,1175,523,13/04/2021
202855,360676,157780,3,Odisha,28086,332590,360679,558922,360676,5310,1279,41,14/02/2021
393627,807886,414170,270032,Odisha,64223,743663,1077918,942940,807886,26522,1866,89,14/03/2021
1927895,3991742,2063315,534834,Odisha,287672,4238904,4526576,3991742,3991742,230520,1323,532,14/04/2021
207190,370662,163428,6416,Odisha,29113,341549,377078,562576,370662,5442,1284,44,15/02/2021
426900,883818,456822,287555,Odisha,67620,816198,1171373,1024675,883818,28342,1913,96,15/03/2021
1985129,4111307,2125632,563836,Odisha,295282,4379861,4675143,4111307,4111307,269530,1481,546,15/04/2021
1980,3420,1440,0,Odisha,19,3401,3420,325232,3420,138,127,0,16/01/2021
207766,373167,165357,7035,Odisha,30088,343079,380202,565550,373167,5531,1286,44,16/02/2021
469500,977933,508324,298501,Odisha,70088,907845,1276434,1117774,977933,29880,1948,109,16/03/2021
2030789,4205256,2173899,586690,Odisha,304688,4487258,4791946,4205256,4205256,243300,1349,568,16/04/2021
2049,3536,1487,0,Odisha,19,3517,3536,330584,3536,322,210,0,17/01/2021
211108,380869,169717,11636,Odisha,31367,349502,392505,571467,380869,5863,1305,44,17/02/2021
503914,1053926,549896,304982,Odisha,72199,981727,1358908,1194647,1053926,31318,2009,116,17/03/2021
2057188,4260933,2203169,603036,Odisha,313935,4550034,4863969,4260933,4260933,162920,826,576,17/04/2021
4861,7591,2729,0,Odisha,184,7407,7591,330555,7591,559,314,1,18/01/2021
201859,373908,172003,34080,Odisha,30707,343201,407988,568772,373908,6103,1315,46,18/02/2021
544845,1144439,599465,311828,Odisha,75158,1069281,1456267,1288749,1144439,32647,2043,129,18/03/2021
2080324,4310037,2229125,618582,Odisha,319190,4609429,4928619,4310037,4310037,219195,1202,588,18/04/2021
8966,14807,5840,0,Odisha,615,14192,14807,336254,14807,678,341,1,19/01/2021
229867,414702,184788,47874,Odisha,32942,381760,462576,577363,414702,6421,1326,47,19/02/2021
580611,1222386,641633,317863,Odisha,77407,1144979,1540249,1373312,1222386,34583,2074,142,19/03/2021
2127029,4409637,2281998,658434,Odisha,328090,4739981,5068071,4409637,4409637,270489,1484,610,19/04/2021
11008,18568,7559,0,Odisha,1020,17548,18568,340900,18568,1010,436,1,20/01/2021
231339,419252,187866,70541,Odisha,33417,385835,489793,578566,419252,6585,1329,47,20/02/2021
622194,1312106,689758,323251,Odisha,81071,1231035,1635357,1464163,1312106,36947,2099,154,20/03/2021
2166063,4495861,2329171,694401,Odisha,336030,4854232,5190262,4495861,4495861,249170,1348,627,20/04/2021
32163,45331,13164,0,Odisha,1405,43926,45331,356813,45331,1284,512,4,21/01/2021
231416,419492,188029,72014,Odisha,33428,386064,491506,578823,419492,6717,1330,47,21/02/2021
635876,1340338,704307,324386,Odisha,81824,1258514,1664724,1484048,1340338,38981,2111,155,21/03/2021
2203203,4577788,2373936,725740,Odisha,343883,4959645,5303528,4577788,4577788,241920,1353,649,21/04/2021
42127,59241,17110,0,Odisha,2171,57070,59241,375661,59241,1527,531,4,22/01/2021
233080,423769,190642,95596,Odisha,34232,389537,519365,579432,423769,6897,1338,47,22/02/2021
660983,1394427,733286,328416,Odisha,84877,1309550,1722843,1549958,1394427,40185,2150,158,22/03/2021
2230429,4642130,2411040,752603,Odisha,350608,5044125,5394733,4642130,4642130,229674,1304,661,22/04/2021
66382,89092,22704,0,Odisha,3082,86010,89092,402331,89092,1670,548,6,23/01/2021
234152,427468,193269,103959,Odisha,34630,392838,531427,580139,427468,7035,1341,47,23/02/2021
706575,1491560,784816,335065,Odisha,89439,1402121,1826625,1639566,1491560,41159,2178,169,23/03/2021
2265820,4720273,2453778,788193,Odisha,362141,5146325,5508466,4720273,4720273,228065,1311,675,23/04/2021
69472,93846,24368,0,Odisha,3806,90040,93846,407522,93846,1872,564,6,24/01/2021
235243,430731,195441,109266,Odisha,35369,395362,539997,581668,430731,7302,1352,47,24/02/2021
733042,1548555,815339,338299,Odisha,92905,1455650,1886854,1696461,1548555,42349,2218,174,24/03/2021
2271979,4733651,2460996,793327,Odisha,362400,5164578,5526978,4733651,4733651,74070,429,676,24/04/2021
91246,120698,29445,0,Odisha,4475,116223,120698,421726,120698,1936,571,7,25/01/2021
238154,437478,199276,126592,Odisha,36267,401211,564070,582358,437478,7471,1354,48,25/02/2021
763812,1614476,850483,343114,Odisha,96182,1518294,1957590,1762438,1614476,43603,2237,181,25/03/2021
2273030,4735952,2462245,794127,Odisha,362409,5167670,5530079,4735952,4735952,57380,333,677,25/04/2021
92901,122870,29962,0,Odisha,4754,118116,122870,423671,122870,1973,578,7,26/01/2021
239302,440499,201149,133291,Odisha,36845,403654,573790,575859,440499,7549,1359,48,26/02/2021
792135,1675411,883090,346662,Odisha,98953,1576458,2022073,1825534,1675411,45112,2259,186,26/03/2021
2297232,4789048,2491130,826238,Odisha,374977,5240309,5615286,4789048,4789048,225330,1296,686,26/04/2021
97942,130317,32368,0,Odisha,6138,124179,130317,426880,130317,2246,664,7,27/01/2021
825028,1742659,917436,349324,Odisha,102773,1639886,2091983,1892273,1742659,46741,2267,195,27/03/2021
2318758,4837588,2518139,854152,Odisha,385280,5306460,5691740,4837588,4837588,212310,1238,691,27/04/2021
109390,145998,36600,0,Odisha,7249,138749,145998,435507,145998,2437,680,8,28/01/2021
830449,1753483,922837,349468,Odisha,102775,1650708,2102951,1900937,1753483,47146,2270,197,28/03/2021
117315,156711,39388,0,Odisha,8193,148518,156711,440629,156711,2481,690,8,29/01/2021
830799,1754126,923130,349489,Odisha,102774,1651352,2103615,1901523,1754126,47926,2272,197,29/03/2021
118197,158329,40124,0,Odisha,9217,149112,158329,443466,158329,2514,698,8,30/01/2021
863516,1822885,959168,357285,Odisha,105394,1717491,2180170,1974102,1822885,50464,2306,201,30/03/2021
118325,158567,40234,0,Odisha,9381,149186,158567,443844,158567,2535,701,8,31/01/2021
897243,1893690,996243,366821,Odisha,107974,1785716,2260511,2047301,1893690,53621,2371,204,31/03/2021
1227,2316,1087,0,Puducherry,0,2316,2316,19647,2316,100,14,2,01/02/2021
32498,67365,34860,6972,Puducherry,45,67320,74337,90252,67365,2368,52,7,01/04/2021
1288,2472,1182,0,Puducherry,0,2472,2472,20057,2472,108,14,2,02/02/2021
5353,10508,5153,1404,Puducherry,0,10508,11912,34287,10508,505,44,2,02/03/2021
32984,68361,35370,7123,Puducherry,45,68316,75484,91124,68361,2519,52,7,02/04/2021
1353,2640,1285,0,Puducherry,0,2640,2640,20491,2640,121,16,2,03/02/2021
5701,11468,5765,1619,Puducherry,0,11468,13087,35143,11468,618,44,2,03/03/2021
34432,71495,37055,7296,Puducherry,45,71450,78791,94641,71495,2551,52,8,03/04/2021
1353,2640,1285,0,Puducherry,0,2640,2640,20532,2640,139,17,2,04/02/2021
6108,12632,6522,1717,Puducherry,0,12632,14349,36247,12632,677,46,2,04/03/2021
36210,75948,39729,7797,Puducherry,74,83671,83745,75948,75948,5800,31,9,04/04/2021
1511,2984,1471,0,Puducherry,0,2984,2984,21064,2984,139,17,2,05/02/2021
6542,13862,7318,1971,Puducherry,0,13862,15833,37533,13862,1276,46,2,05/03/2021
36839,77297,40449,8007,Puducherry,74,85230,85304,77297,77297,7600,37,9,05/04/2021
1511,2984,1471,0,Puducherry,0,2984,2984,21069,2984,141,17,2,06/02/2021
7041,14965,7922,2216,Puducherry,0,14965,17181,38542,14965,1312,46,2,06/03/2021
37045,77736,40682,8091,Puducherry,74,85753,85827,77736,77736,7500,36,9,06/04/2021
1511,2984,1471,0,Puducherry,0,2984,2984,21153,2984,146,17,2,07/02/2021
7042,14969,7925,2217,Puducherry,0,14969,17186,38543,14969,1320,46,2,07/03/2021
37678,79066,41379,8300,Puducherry,74,87292,87366,79066,79066,7700,37,9,07/04/2021
1668,3326,1656,0,Puducherry,0,3326,3326,22144,3326,150,17,2,08/02/2021
7637,16432,8793,2408,Puducherry,0,16432,18840,39964,16432,1344,47,2,08/03/2021
38770,81449,42669,8724,Puducherry,74,90099,90173,81449,81449,7800,39,10,08/04/2021
1884,3728,1842,0,Puducherry,0,3728,3728,22907,3728,157,17,2,09/02/2021
8101,17565,9462,2688,Puducherry,0,17565,20253,41060,17565,1410,48,2,09/03/2021
39879,83995,44105,9175,Puducherry,74,93096,93170,83995,83995,8100,38,11,09/04/2021
2077,4135,2056,0,Puducherry,0,4135,4135,24583,4135,167,19,2,10/02/2021
8667,19072,10403,2925,Puducherry,1,19071,21997,42438,19072,1445,49,2,10/03/2021
41331,87196,45854,9615,Puducherry,74,96737,96811,87196,87196,6900,41,11,10/04/2021
2079,4144,2063,0,Puducherry,0,4144,4144,24940,4144,172,19,2,11/02/2021
9245,20577,11330,3101,Puducherry,1,20576,23678,43852,20577,1479,49,2,11/03/2021
44512,93853,49329,9767,Puducherry,74,103546,103620,93853,93853,10550,62,12,11/04/2021
2381,4740,2357,0,Puducherry,0,4740,4740,25991,4740,176,20,2,12/02/2021
9865,21866,11999,3352,Puducherry,1,21865,25218,45054,21866,1496,50,2,12/03/2021
49748,104283,54522,10342,Puducherry,74,114551,114625,104283,104283,12500,65,13,12/04/2021
2625,5243,2616,68,Puducherry,0,5243,5311,27670,5243,188,22,2,13/02/2021
10639,23409,12768,3616,Puducherry,1,23408,27025,46490,23409,1503,50,2,13/03/2021
56917,118447,61515,10868,Puducherry,74,129241,129315,118447,118447,13400,64,15,13/04/2021
2625,5243,2616,68,Puducherry,0,5243,5311,27717,5243,201,22,2,14/02/2021
10663,23450,12785,3618,Puducherry,1,23449,27068,46529,23450,1511,50,2,14/03/2021
61386,127116,65715,11111,Puducherry,74,138153,138227,127116,127116,14150,62,15,14/04/2021
2919,5784,2863,190,Puducherry,0,5784,5974,29153,5784,217,22,2,15/02/2021
11613,25449,13834,3837,Puducherry,1,25448,29286,48579,25449,1560,51,2,15/03/2021
66648,136506,69841,11957,Puducherry,74,148389,148463,136506,136506,14900,64,17,15/04/2021
40,92,52,0,Puducherry,0,92,92,13197,92,11,9,0,16/01/2021
3118,6197,3077,305,Puducherry,0,6197,6502,30462,6197,253,24,2,16/02/2021
12714,27752,15036,4095,Puducherry,1,27751,31847,50791,27752,1595,52,2,16/03/2021
71028,144696,73651,12872,Puducherry,74,157494,157568,144696,144696,14700,64,17,16/04/2021
40,92,52,0,Puducherry,0,92,92,13205,92,19,9,0,17/01/2021
3384,6715,3329,357,Puducherry,0,6715,7072,32003,6715,266,24,2,17/02/2021
14127,30616,16486,4272,Puducherry,1,30615,34888,53549,30616,1616,52,3,17/03/2021
74090,150119,76011,13719,Puducherry,74,163764,163838,150119,150119,13700,63,18,17/04/2021
51,128,77,0,Puducherry,0,128,128,11410,128,25,9,0,18/01/2021
3563,7023,3458,410,Puducherry,0,7023,7433,29991,7023,283,28,2,18/02/2021
15292,33201,17906,4597,Puducherry,2,33199,37798,55970,33201,1652,52,3,18/03/2021
74937,151720,76763,14000,Puducherry,74,165646,165720,151720,151720,13500,64,20,18/04/2021
111,249,138,0,Puducherry,0,249,249,12692,249,31,9,0,19/01/2021
4253,8264,4009,599,Puducherry,0,8264,8863,33682,8264,291,28,2,19/02/2021
16263,35241,18975,4967,Puducherry,2,35239,40208,57974,35241,1689,52,3,19/03/2021
75942,153689,77727,15057,Puducherry,74,168672,168746,153689,153689,12600,60,20,19/04/2021
111,249,138,0,Puducherry,0,249,249,12717,249,31,9,0,20/01/2021
4696,8983,4285,807,Puducherry,0,8983,9790,33685,8983,295,28,2,20/02/2021
17937,38289,20348,5417,Puducherry,3,38286,43706,61079,38289,1721,52,4,20/03/2021
76638,155023,78365,15861,Puducherry,74,170810,170884,155023,155023,13400,65,20,20/04/2021
111,249,138,0,Puducherry,0,249,249,14895,249,36,9,0,21/01/2021
17999,38428,20425,5426,Puducherry,3,38425,43854,61117,38428,1730,52,4,21/03/2021
77703,157027,79304,16815,Puducherry,74,173768,173842,157027,157027,10600,64,20,21/04/2021
185,440,255,0,Puducherry,0,440,440,16520,440,50,9,0,22/01/2021
4754,9092,4336,931,Puducherry,0,9092,10023,33687,9092,330,28,2,22/02/2021
19392,41147,21751,5631,Puducherry,4,41143,46778,63963,41147,2030,52,4,22/03/2021
78643,158784,80120,17848,Puducherry,74,176558,176632,158784,158784,10700,65,21,22/04/2021
359,813,454,0,Puducherry,0,813,813,16788,813,55,9,0,23/01/2021
4791,9167,4374,965,Puducherry,0,9167,10132,33834,9167,337,28,2,23/02/2021
20903,44185,23278,5868,Puducherry,24,44161,50053,66892,44185,2051,52,4,23/03/2021
79525,160575,81029,19018,Puducherry,74,179519,179593,160575,160575,10800,65,21,23/04/2021
393,870,477,0,Puducherry,0,870,870,17205,870,57,9,0,24/01/2021
4867,9295,4426,993,Puducherry,0,9295,10288,33918,9295,349,29,2,24/02/2021
23268,48685,25413,5971,Puducherry,42,48643,54656,71457,48685,2061,52,4,24/03/2021
80169,161889,81699,19904,Puducherry,74,181719,181793,161889,161889,9700,57,21,24/04/2021
579,1200,621,0,Puducherry,0,1200,1200,17582,1200,62,9,0,25/01/2021
5033,9583,4548,1016,Puducherry,0,9583,10599,34018,9583,361,29,2,25/02/2021
24541,51281,26736,6088,Puducherry,42,51239,57369,74093,51281,2081,52,4,25/03/2021
80340,162241,81880,20135,Puducherry,74,182302,182376,162241,162241,10400,60,21,25/04/2021
583,1205,622,0,Puducherry,0,1205,1205,17597,1205,62,9,0,26/01/2021
5175,10049,4872,1205,Puducherry,0,10049,11254,33899,10049,370,30,2,26/02/2021
25887,53969,28078,6254,Puducherry,43,53926,60223,76692,53969,2107,52,4,26/03/2021
80945,163596,82629,21645,Puducherry,74,185167,185241,163596,163596,15000,62,22,26/04/2021
626,1274,648,0,Puducherry,0,1274,1274,17700,1274,62,9,0,27/01/2021
27019,56118,29095,6359,Puducherry,43,56075,62477,78807,56118,2118,52,4,27/03/2021
81526,164814,83266,23083,Puducherry,74,187823,187897,164814,164814,12600,63,22,27/04/2021
637,1302,665,0,Puducherry,0,1302,1302,17913,1302,74,10,0,28/01/2021
27107,56299,29188,6365,Puducherry,43,56256,62664,78982,56299,2120,52,4,28/03/2021
863,1684,820,0,Puducherry,0,1684,1684,18604,1684,82,10,1,29/01/2021
27962,58071,30105,6456,Puducherry,44,58027,64527,80843,58071,2335,52,4,29/03/2021
1106,2069,961,0,Puducherry,0,2069,2069,19295,2069,84,10,2,30/01/2021
29934,61849,31910,6587,Puducherry,45,61804,68436,84701,61849,2355,52,5,30/03/2021
1108,2077,967,0,Puducherry,0,2077,2077,19296,2077,95,14,2,31/01/2021
31504,65249,33739,6790,Puducherry,45,65204,72039,88113,65249,2363,52,6,31/03/2021
24694,47903,23207,0,Punjab,0,47903,47903,212543,47903,2230,375,2,01/02/2021
330143,840309,510106,112960,Punjab,64765,775544,953269,1065831,840309,79786,3148,60,01/04/2021
25686,49663,23975,0,Punjab,0,49663,49663,218435,49663,2375,387,2,02/02/2021
52838,163048,110201,35973,Punjab,485,162563,199021,400587,163048,8954,566,9,02/03/2021
355358,903110,547684,116171,Punjab,66438,836672,1019281,1128191,903110,84510,3308,68,02/04/2021
26986,52241,25252,0,Punjab,0,52241,52241,223675,52241,2612,408,3,03/02/2021
55731,173112,117372,38350,Punjab,1059,172053,211462,408243,173112,10154,628,9,03/03/2021
383065,972083,588944,119791,Punjab,68028,904055,1091874,1207488,972083,89215,3421,74,03/04/2021
28384,56208,27820,0,Punjab,0,56208,56208,232873,56208,2856,418,4,04/02/2021
59458,183847,124380,40539,Punjab,1843,182004,224386,417696,183847,11050,690,9,04/03/2021
445942,1116418,670370,121556,Punjab,76834,1161140,1237974,1116418,1116418,351380,2181,106,04/04/2021
29775,60878,31099,0,Punjab,0,60878,60878,244887,60878,3030,432,4,05/02/2021
64214,197223,133000,43277,Punjab,3057,194166,240500,429512,197223,12118,733,9,05/03/2021
475777,1184561,708672,125691,Punjab,78049,1232203,1310252,1184561,1184561,408680,2626,112,05/04/2021
30545,64399,33847,0,Punjab,0,64399,64399,252928,64399,3108,432,7,06/02/2021
68345,208515,140161,45832,Punjab,4323,204192,254347,439635,208515,12974,744,9,06/03/2021
494033,1226129,731981,128042,Punjab,78889,1275282,1354171,1226129,1226129,420950,2750,115,06/04/2021
30546,64401,33848,0,Punjab,0,64401,64401,253989,64401,3277,433,7,07/02/2021
68986,209935,140940,45923,Punjab,4524,205411,255858,441135,209935,13750,753,9,07/03/2021
542169,1334736,792437,134551,Punjab,81609,1387678,1469287,1334736,1334736,395455,2774,130,07/04/2021
31912,70250,38331,0,Punjab,12,70238,70250,265945,70250,3521,439,7,08/02/2021
75225,226539,151302,49220,Punjab,6194,220345,275759,456643,226539,14791,786,12,08/03/2021
586454,1430914,844326,139949,Punjab,83179,1487684,1570863,1430914,1430914,403296,2845,134,08/04/2021
33232,75851,42612,0,Punjab,29,75822,75851,278019,75851,3684,440,7,09/02/2021
81135,242286,161139,53001,Punjab,7918,234368,295287,471354,242286,15853,819,12,09/03/2021
629552,1526823,897127,145702,Punjab,84878,1587647,1672525,1526823,1526823,412700,3029,144,09/04/2021
34122,80350,46221,0,Punjab,29,80321,80350,290180,80350,3903,442,7,10/02/2021
86285,256132,169835,56328,Punjab,9783,246349,312460,484295,256132,16804,840,12,10/03/2021
672103,1618233,945976,151307,Punjab,86894,1682646,1769540,1618233,1618233,408751,2949,154,10/04/2021
35337,85911,50566,0,Punjab,30,85881,85911,302743,85911,4127,447,8,11/02/2021
88969,262106,173124,56892,Punjab,11118,250988,318998,490124,262106,17813,858,13,11/03/2021
706288,1690799,984345,154115,Punjab,88519,1756395,1844914,1690799,1690799,358350,2716,166,11/04/2021
36282,90012,53722,0,Punjab,31,89981,90012,319809,90012,4272,448,8,12/02/2021
95243,278514,183257,61468,Punjab,12964,265550,339982,505557,278514,19078,898,14,12/03/2021
746819,1776693,1029695,161989,Punjab,90221,1848461,1938682,1776693,1776693,404550,3136,179,12/04/2021
36598,91988,55382,62,Punjab,74,91914,92050,329629,91988,4334,451,8,13/02/2021
101752,294377,192610,64804,Punjab,14772,279605,359181,520714,294377,20228,951,15,13/03/2021
773554,1835859,1062116,166491,Punjab,91248,1911102,2002350,1835859,1835859,393115,3075,189,13/04/2021
36598,91988,55382,62,Punjab,74,91914,92050,331736,91988,4457,452,8,14/02/2021
102805,296783,193963,64901,Punjab,15238,281545,361684,523014,296783,22072,1020,15,14/03/2021
807783,1907408,1099429,172918,Punjab,92673,1987653,2080326,1907408,1907408,395472,3110,196,14/04/2021
37582,96153,58562,1028,Punjab,76,96077,97181,342878,96153,4686,453,9,15/02/2021
111147,317996,206834,69032,Punjab,17570,300426,387028,543360,317996,24085,1099,15,15/03/2021
842310,1981682,1139165,183327,Punjab,94001,2071008,2165009,1981682,1981682,409005,3192,207,15/04/2021
164,336,172,0,Punjab,0,336,336,132329,336,63,55,0,16/01/2021
38531,100270,61730,1988,Punjab,76,100194,102258,353350,100270,4855,453,9,16/02/2021
120271,340327,220040,72831,Punjab,20771,319556,413158,564783,340327,26542,1174,16,16/03/2021
880538,2066797,1186042,194556,Punjab,95975,2165378,2261353,2066797,2066797,403925,3181,217,16/04/2021
166,338,172,0,Punjab,0,338,338,133417,338,141,66,0,17/01/2021
39358,103601,64234,2678,Punjab,80,103521,106279,368053,103601,5115,454,9,17/02/2021
128255,360167,231896,75622,Punjab,23899,336268,435789,583682,360167,28313,1227,16,17/03/2021
915975,2145690,1229489,206557,Punjab,109919,2242328,2352247,2145690,2145690,414150,3232,226,17/04/2021
350,678,328,0,Punjab,0,678,678,140762,678,223,92,0,18/01/2021
37890,102775,64876,4974,Punjab,85,102690,107749,357038,102775,5406,455,9,18/02/2021
138424,385522,247080,78889,Punjab,27629,357893,464411,608466,385522,31396,1384,18,18/03/2021
943855,2205031,1260945,213040,Punjab,139755,2278316,2418071,2205031,2205031,426863,3310,231,18/04/2021
770,1529,759,0,Punjab,0,1529,1529,145594,1529,286,118,0,19/01/2021
42099,113959,71851,8567,Punjab,87,113872,122526,391950,113959,5639,457,9,19/02/2021
149638,413236,263577,82169,Punjab,31835,381401,495405,636688,413236,34533,1455,21,19/03/2021
977989,2279891,1301666,227629,Punjab,170585,2336935,2507520,2279891,2279891,467821,3684,236,19/04/2021
1211,2432,1221,0,Punjab,0,2432,2432,146706,2432,398,163,0,20/01/2021
42633,116708,74066,12291,Punjab,91,116617,128999,392224,116708,5726,457,9,20/02/2021
163350,445608,282235,84762,Punjab,36451,409157,530370,668825,445608,36786,1464,23,20/03/2021
1010775,2352465,1341443,242272,Punjab,200643,2394094,2594737,2352465,2352465,482948,3783,247,20/04/2021
2346,4780,2434,0,Punjab,0,4780,4780,150770,4780,656,266,0,21/01/2021
42671,116815,74135,12695,Punjab,91,116724,129510,392287,116815,5863,457,9,21/02/2021
167566,455628,288039,85226,Punjab,37983,417645,540854,677726,455628,39638,1475,23,21/03/2021
1034135,2403286,1368903,254368,Punjab,222491,2435163,2657654,2403286,2403286,455970,3601,248,21/04/2021
4892,9676,4784,0,Punjab,0,9676,9676,157415,9676,885,319,0,22/01/2021
43730,121967,78228,18347,Punjab,118,121849,140314,392390,121967,6159,458,9,22/02/2021
180121,485030,304885,88605,Punjab,41795,443235,573635,708997,485030,41170,1504,24,22/03/2021
1054865,2448621,1393501,266324,Punjab,247670,2467275,2714945,2448621,2448621,450860,3546,255,22/04/2021
8242,16519,8277,0,Punjab,0,16519,16519,163524,16519,988,324,0,23/01/2021
44932,128224,83283,21320,Punjab,122,128102,149544,392427,128224,6398,460,9,23/02/2021
193368,516186,322794,91811,Punjab,46173,470013,607997,738025,516186,43482,1525,24,23/03/2021
1089281,2526188,1436640,285698,Punjab,260445,2551441,2811886,2526188,2526188,464015,3676,267,23/04/2021
8899,17712,8813,0,Punjab,0,17712,17712,167001,17712,1189,352,0,24/01/2021
46139,134183,88035,24449,Punjab,127,134056,158632,392483,134183,6702,462,9,24/02/2021
205161,544828,339641,94098,Punjab,49226,495602,638926,766357,544828,45570,1550,26,24/03/2021
1130127,2616660,1486258,307607,Punjab,269488,2654779,2924267,2616660,2616660,441050,3607,275,24/04/2021
13198,26017,12818,0,Punjab,0,26017,26017,176331,26017,1277,359,1,25/01/2021
48669,143306,94628,29291,Punjab,132,143174,172597,392512,143306,6952,463,9,25/02/2021
219167,577777,358580,96969,Punjab,52374,525403,674746,799039,577777,48082,1578,30,25/03/2021
1157570,2676116,1518263,318920,Punjab,271972,2723064,2995036,2676116,2676116,399500,3232,283,25/04/2021
13282,26213,12930,0,Punjab,0,26213,26213,177130,26213,1375,361,1,26/01/2021
49718,149199,99472,32494,Punjab,151,149048,181693,392393,149199,7068,463,9,26/02/2021
232522,610286,377731,98974,Punjab,55421,554865,709260,831443,610286,49702,1644,33,26/03/2021
1189325,2746637,1557024,339004,Punjab,276911,2808730,3085641,2746637,2746637,440900,3558,288,26/04/2021
16689,33121,16431,0,Punjab,0,33121,33121,184899,33121,1621,367,1,27/01/2021
251905,653571,401628,100968,Punjab,58152,595419,754539,874312,653571,51959,1714,38,27/03/2021
1203337,2779190,1575563,352240,Punjab,280330,2851100,3131430,2779190,2779190,386250,3130,290,27/04/2021
20209,39511,19300,0,Punjab,0,39511,39511,192373,39511,1835,373,2,28/01/2021
49718,149199,99472,32494,Punjab,151,149048,181693,392394,149199,7272,470,9,28/02/2021
259648,672057,412364,101509,Punjab,58879,613178,773566,892738,672057,55307,1886,45,28/03/2021
21708,42210,20500,0,Punjab,0,42210,42210,200506,42210,1952,375,2,29/01/2021
267805,690928,423078,102395,Punjab,59518,631410,793323,911158,690928,60266,2074,45,29/03/2021
23600,45648,22046,0,Punjab,0,45648,45648,206196,45648,2001,375,2,30/01/2021
287056,736460,449356,105632,Punjab,61454,675006,842092,956465,736460,65667,2356,48,30/03/2021
23636,45738,22100,0,Punjab,0,45738,45738,206875,45738,2107,375,2,31/01/2021
306084,782667,476532,109542,Punjab,62959,719708,892209,1002524,782667,74017,2823,51,31/03/2021
184170,313321,129104,0,Rajasthan,7775,305546,313321,582813,313321,6924,2622,47,01/02/2021
2371065,4938430,2566758,725111,Rajasthan,207515,4730915,5663541,5214078,4938430,152602,11053,607,01/04/2021
186913,319352,132391,0,Rajasthan,7846,311506,319352,594526,319352,7829,2737,48,02/02/2021
383880,963857,579882,250003,Rajasthan,168009,795848,1213860,1126646,963857,27612,4758,95,02/03/2021
2509850,5218729,2708243,762556,Rajasthan,210187,5008542,5981285,5499553,5218729,158003,11310,636,02/04/2021
201253,343265,141962,0,Rajasthan,8230,335035,343265,626307,343265,8356,2909,50,03/02/2021
474571,1160351,685656,263418,Rajasthan,168392,991959,1423769,1331991,1160351,32197,5222,124,03/03/2021
2633867,5468449,2833918,796850,Rajasthan,212732,5255717,6265299,5778299,5468449,162490,11452,664,03/04/2021
204608,364452,159794,0,Rajasthan,8486,355966,364452,637724,364452,8899,3100,50,04/02/2021
518483,1256310,737692,276049,Rajasthan,168611,1087699,1532359,1434235,1256310,37461,5535,135,04/03/2021
2873395,5958784,3084650,843485,Rajasthan,360390,6441879,6802269,5958784,5958784,814378,3565,739,04/04/2021
213198,392138,178890,0,Rajasthan,14621,377517,392138,654065,392138,9657,3415,50,05/02/2021
627596,1486399,858629,297090,Rajasthan,169388,1317011,1783489,1679516,1486399,44135,5659,174,05/03/2021
3026773,6257503,3229952,883341,Rajasthan,364815,6776029,7140844,6257503,6257503,985230,4365,778,05/04/2021
217712,434782,217019,0,Rajasthan,41376,393406,434782,667656,434782,9814,3450,51,06/02/2021
733943,1704633,970477,319420,Rajasthan,171194,1533439,2024053,1899022,1704633,45889,5687,213,06/03/2021
3172210,6542132,3369101,914100,Rajasthan,367699,7088533,7456232,6542132,6542132,1007765,4594,821,06/04/2021
217874,436384,218459,0,Rajasthan,41376,395008,436384,678101,436384,10307,3554,51,07/02/2021
740162,1716982,976607,320170,Rajasthan,171308,1545674,2037152,1909857,1716982,48439,5748,213,07/03/2021
3498656,7175412,3675847,973709,Rajasthan,375787,7773334,8149121,7175412,7175412,932773,4228,909,07/04/2021
220884,462139,241204,0,Rajasthan,60860,401279,462139,693584,462139,10354,3563,51,08/02/2021
821696,1888485,1066552,337125,Rajasthan,173356,1715129,2225610,2085259,1888485,50416,5807,237,08/03/2021
3812144,7767712,3954578,1034865,Rajasthan,384033,8418544,8802577,7767712,7767712,913200,4047,990,08/04/2021
221583,467360,245726,0,Rajasthan,63847,403513,467360,700896,467360,11159,3738,51,09/02/2021
844269,1937481,1092966,356673,Rajasthan,177005,1760476,2294154,2132639,1937481,53064,5877,246,09/03/2021
4020764,8164413,4142607,1078051,Rajasthan,392807,8849657,9242464,8164413,8164413,1021361,4487,1042,09/04/2021
229664,534459,304744,0,Rajasthan,104265,430194,534459,714662,534459,12011,3879,51,10/02/2021
885758,2027319,1141302,399216,Rajasthan,182956,1844363,2426535,2223859,2027319,55770,5908,259,10/03/2021
4170906,8448722,4276726,1114875,Rajasthan,406725,9156872,9563597,8448722,8448722,737480,3333,1090,10/04/2021
242271,566165,323837,0,Rajasthan,112490,453675,566165,748869,566165,12418,3925,57,11/02/2021
887004,2030306,1143043,400274,Rajasthan,183456,1846850,2430580,2226042,2030306,58753,5986,259,11/03/2021
4237808,8581755,4342828,1133804,Rajasthan,419409,9296150,9715559,8581755,8581755,755450,3314,1119,11/04/2021
244927,582386,337402,0,Rajasthan,122064,460322,582386,768946,582386,12550,3932,57,12/02/2021
959873,2181839,1221697,428852,Rajasthan,187340,1994499,2610691,2380282,2181839,64694,6066,269,12/03/2021
4329262,8758751,4428336,1165625,Rajasthan,435841,9488535,9924376,8758751,8758751,847609,3722,1153,12/04/2021
245581,585570,339932,0,Rajasthan,123301,462269,585570,782843,585570,12601,3939,57,13/02/2021
1045308,2352878,1307286,443796,Rajasthan,189151,2163727,2796674,2556346,2352878,66447,6107,284,13/03/2021
4394703,8885930,4490062,1194329,Rajasthan,443043,9637216,10080259,8885930,8885930,905490,3938,1165,13/04/2021
245599,586110,340454,0,Rajasthan,123790,462320,586110,785255,586110,12893,3962,57,14/02/2021
1050152,2362568,1312132,444118,Rajasthan,189222,2173346,2806686,2563688,2362568,70823,6333,284,14/03/2021
4451331,8996238,4543719,1227364,Rajasthan,449571,9774031,10223602,8996238,8996238,603620,2798,1188,14/04/2021
250082,603314,353175,8179,Rajasthan,127608,475706,611493,804180,603314,13144,3990,57,15/02/2021
1141015,2544415,1403093,457960,Rajasthan,190992,2353423,3002375,2752739,2544415,75979,6709,307,15/03/2021
4499024,9093355,4593132,1264332,Rajasthan,459984,9897703,10357687,9093355,9093355,843904,3907,1199,15/04/2021
1249,3285,2036,0,Rajasthan,117,3168,3285,371438,3285,185,170,0,16/01/2021
253439,612615,359118,13866,Rajasthan,128885,483730,626481,948680,612615,13994,4246,58,16/02/2021
1248695,2755659,1506631,470938,Rajasthan,192609,2563050,3226597,2966464,2755659,81758,7117,333,16/03/2021
4557254,9206593,4648129,1316093,Rajasthan,472184,10050502,10522686,9206593,9206593,833373,3843,1210,16/04/2021
1292,3455,2163,0,Rajasthan,118,3337,3455,372195,3455,461,199,0,17/01/2021
289405,732921,443457,14561,Rajasthan,157772,575149,747482,968296,732921,14076,4248,59,17/02/2021
1363754,2987238,1623123,578725,Rajasthan,196111,2791127,3565963,3203090,2987238,86035,7296,361,17/03/2021
4616890,9330653,4712539,1365602,Rajasthan,482336,10213919,10696255,9330653,9330653,525550,2501,1224,17/04/2021
1710,4037,2326,0,Rajasthan,232,3805,4037,371382,4037,744,266,1,18/01/2021
281050,717526,436418,14879,Rajasthan,158765,558761,732405,924907,717526,14748,4306,58,18/02/2021
1388117,3036442,1647956,592338,Rajasthan,197123,2839319,3628780,3250280,3036442,91397,7904,369,18/03/2021
4679435,9457932,4777265,1425240,Rajasthan,490276,10392896,10883172,9457932,9457932,862716,4009,1232,18/04/2021
5979,13022,7042,0,Rajasthan,681,12341,13022,377395,13022,838,284,1,19/01/2021
301096,772221,471062,18015,Rajasthan,165082,607139,790236,980872,772221,15124,4307,63,19/02/2021
1498518,3253100,1754179,621011,Rajasthan,198445,3054655,3874111,3490796,3253100,98614,8280,403,19/03/2021
4779687,9659550,4878583,1530556,Rajasthan,507024,10683082,11190106,9659550,9659550,1024569,4933,1280,19/04/2021
6043,13146,7102,0,Rajasthan,681,12465,13146,379578,13146,970,319,1,20/01/2021
301575,773238,471600,36825,Rajasthan,165255,607983,810063,981024,773238,15191,4307,63,20/02/2021
1616728,3480563,1863404,633239,Rajasthan,199281,3281282,4113802,3711530,3480563,103165,8516,431,20/03/2021
4863225,9828071,4963543,1622245,Rajasthan,521341,10928975,11450316,9828071,9828071,964799,4707,1303,20/04/2021
6345,13605,7259,0,Rajasthan,681,12924,13605,385118,13605,1167,364,1,21/01/2021
301576,773239,471600,36838,Rajasthan,165255,607984,810077,981067,773239,15470,4308,63,21/02/2021
1636410,3518084,1881238,634187,Rajasthan,199358,3318726,4152271,3739063,3518084,106971,8793,436,21/03/2021
4924689,9952126,5026114,1697024,Rajasthan,530945,11118205,11649150,9952126,9952126,733859,3602,1323,21/04/2021
11738,24545,12804,0,Rajasthan,951,23594,24545,398034,24545,1507,552,3,22/01/2021
301675,773521,471787,62973,Rajasthan,165282,608239,836494,981386,773521,15936,4310,59,22/02/2021
1722965,3686204,1962782,640027,Rajasthan,200140,3486064,4326231,3930902,3686204,113046,9153,457,22/03/2021
4983057,10068970,5084570,1765911,Rajasthan,547308,11287573,11834881,10068970,10068970,893013,4330,1343,22/04/2021
23961,47915,23942,0,Rajasthan,1180,46735,47915,414390,47915,2113,789,12,23/01/2021
301862,774043,472122,92142,Rajasthan,165455,608588,866185,981912,774043,16673,4311,59,23/02/2021
1848582,3924651,2075596,645172,Rajasthan,201887,3722764,4569823,4157319,3924651,117793,9620,473,23/03/2021
5035933,10178146,5140847,1831688,Rajasthan,564359,11445475,12009834,10178146,10178146,857427,4142,1366,23/04/2021
39036,74727,35678,0,Rajasthan,1651,73076,74727,429195,74727,3169,1451,13,24/01/2021
302174,774498,472265,145389,Rajasthan,165474,609024,919887,982321,774498,17213,4364,59,24/02/2021
1962256,4140029,2177281,649208,Rajasthan,202801,3937228,4789237,4377885,4140029,122978,9806,492,24/03/2021
5095715,10298265,5201166,1908851,Rajasthan,577931,11629185,12207116,10298265,10298265,588150,2988,1384,24/04/2021
81757,141245,59459,0,Rajasthan,2365,138880,141245,461895,141245,3769,1768,29,25/01/2021
305686,788094,482335,151718,Rajasthan,167268,620826,939812,982564,788094,18219,4369,73,25/02/2021
1997032,4207663,2210129,652618,Rajasthan,203356,4004307,4860281,4443877,4207663,129217,10156,502,25/03/2021
5140063,10388394,5246928,1959332,Rajasthan,586354,11761372,12347726,10388394,10388394,538980,2674,1403,25/04/2021
81899,141527,59599,0,Rajasthan,2365,139162,141527,465456,141527,4471,2087,29,26/01/2021
306532,789478,482873,220942,Rajasthan,167373,622105,1010420,942350,789478,18338,4371,73,26/02/2021
2102290,4409850,2307031,657243,Rajasthan,204215,4205635,5067093,4658717,4409850,134746,10461,529,26/03/2021
5198328,10507761,5308015,2034069,Rajasthan,595246,11946584,12541830,10507761,10507761,803097,3925,1418,26/04/2021
130513,218831,88284,0,Rajasthan,4864,213967,218831,494100,218831,5002,2233,34,27/01/2021
2198873,4592778,2393351,660361,Rajasthan,204930,4387848,5253139,4839391,4592778,136875,10533,554,27/03/2021
5232108,10578840,5345296,2081105,Rajasthan,603228,12056717,12659945,10578840,10578840,756451,3650,1436,27/04/2021
140275,239877,99567,0,Rajasthan,7030,232847,239877,513197,239877,6174,2594,35,28/01/2021
2203249,4600936,2397130,660445,Rajasthan,204930,4396006,5261381,4845660,4600936,137840,10623,557,28/03/2021
179088,302265,123136,0,Rajasthan,7775,294490,302265,544685,302265,6350,2605,41,29/01/2021
181841,307923,126035,0,Rajasthan,7775,300148,307923,560057,307923,6457,2609,47,30/01/2021
2241710,4675588,2433310,676591,Rajasthan,205437,4470151,5352179,4922692,4675588,142788,10876,568,30/03/2021
182597,309565,126921,0,Rajasthan,7775,301790,309565,572193,309565,6538,2611,47,31/01/2021
2297549,4784074,2485935,701227,Rajasthan,206224,4577850,5485301,5033946,4784074,147709,10965,590,31/03/2021
1222,1855,633,0,Sikkim,0,1855,1855,20720,1855,74,16,0,01/02/2021
28774,64671,35890,13384,Sikkim,229,64442,78055,72414,64671,2047,164,7,01/04/2021
1550,2336,786,0,Sikkim,0,2336,2336,20853,2336,99,24,0,02/02/2021
7721,18890,11169,2101,Sikkim,189,18701,20991,26588,18890,421,39,0,02/03/2021
29149,65427,36271,13408,Sikkim,230,65197,78835,72713,65427,2102,165,7,02/04/2021
2153,3084,931,0,Sikkim,0,3084,3084,21216,3084,120,26,0,03/02/2021
8238,20235,11997,2367,Sikkim,190,20045,22602,27740,20235,720,48,0,03/03/2021
29425,66027,36595,13426,Sikkim,230,65797,79453,73424,66027,2121,165,7,03/04/2021
2739,3923,1184,0,Sikkim,0,3923,3923,21773,3923,125,28,0,04/02/2021
8879,21853,12973,2769,Sikkim,194,21659,24622,29224,21853,738,48,1,04/03/2021
30260,66530,36263,12662,Sikkim,0,79192,79192,66530,66530,800,3,7,04/04/2021
3365,4857,1492,0,Sikkim,0,4857,4857,22071,4857,128,28,0,05/02/2021
9655,23624,13967,3822,Sikkim,201,23423,27446,31026,23624,880,77,2,05/03/2021
31734,69217,37475,12842,Sikkim,0,82059,82059,69217,69217,6990,38,8,05/04/2021
3532,5089,1557,0,Sikkim,0,5089,5089,22639,5089,131,30,0,06/02/2021
10295,25221,14924,4256,Sikkim,201,25020,29477,32505,25221,931,77,2,06/03/2021
33474,72723,39241,13024,Sikkim,0,85747,85747,72723,72723,9450,54,8,06/04/2021
3532,5090,1558,0,Sikkim,0,5090,5090,23232,5090,138,34,0,07/02/2021
37458,80892,43424,13534,Sikkim,0,94426,94426,80892,80892,10270,55,10,07/04/2021
4031,5726,1695,0,Sikkim,1,5725,5726,23553,5726,141,34,0,08/02/2021
11429,27834,16402,5204,Sikkim,208,27626,33038,35159,27834,1004,83,3,08/03/2021
41846,90081,48224,14392,Sikkim,0,104473,104473,90081,90081,12950,72,11,08/04/2021
4716,6653,1937,0,Sikkim,6,6647,6653,23905,6653,152,35,0,09/02/2021
12457,30116,17655,5955,Sikkim,210,29906,36071,37529,30116,1011,84,4,09/03/2021
45263,97386,52111,15028,Sikkim,0,112414,112414,97386,97386,11950,68,12,09/04/2021
5306,7478,2172,0,Sikkim,6,7472,7478,24543,7478,157,35,0,10/02/2021
13847,33298,19447,6516,Sikkim,211,33087,39814,40770,33298,1067,84,4,10/03/2021
46450,99963,53501,15238,Sikkim,0,115201,115201,99963,99963,8100,40,12,10/04/2021
5616,8022,2406,0,Sikkim,6,8016,8022,24952,8022,160,35,0,11/02/2021
15260,36259,20994,7307,Sikkim,212,36047,43566,43711,36259,1140,94,5,11/03/2021
47269,101795,54514,15376,Sikkim,0,117171,117171,101795,101795,5880,28,12,11/04/2021
5625,8041,2416,0,Sikkim,6,8035,8041,24962,8041,160,35,0,12/02/2021
16499,38860,22356,7584,Sikkim,213,38647,46444,46302,38860,1212,97,5,12/03/2021
51160,109886,58712,15945,Sikkim,0,125831,125831,109886,109886,13380,70,14,12/04/2021
16603,39116,22508,7585,Sikkim,213,38903,46701,46556,39116,1253,101,5,13/03/2021
55393,118962,63554,16493,Sikkim,0,135455,135455,118962,118962,12850,72,15,13/04/2021
57875,124532,66641,17245,Sikkim,0,141777,141777,124532,124532,12660,71,16,14/04/2021
5661,8252,2591,0,Sikkim,6,8246,8252,25044,8252,185,35,0,15/02/2021
17818,41716,23893,7858,Sikkim,218,41498,49574,49174,41716,1476,148,5,15/03/2021
60433,130118,69669,18437,Sikkim,0,148555,148555,130118,130118,13810,76,16,15/04/2021
4,7,3,0,Sikkim,0,7,7,11519,7,2,2,0,16/01/2021
5817,8849,3032,157,Sikkim,6,8843,9006,25191,8849,206,35,0,16/02/2021
18751,43718,24962,8152,Sikkim,225,43493,51870,51084,43718,1516,149,5,16/03/2021
62859,135490,72614,19751,Sikkim,0,155241,155241,135490,135490,13050,75,17,16/04/2021
4,7,3,0,Sikkim,0,7,7,11912,7,2,2,0,17/01/2021
5984,9463,3479,251,Sikkim,6,9457,9714,25520,9463,229,35,0,17/02/2021
19766,45962,26191,8546,Sikkim,225,45737,54508,53326,45962,1533,149,5,17/03/2021
64566,139394,74811,20729,Sikkim,0,160123,160123,139394,139394,9100,50,17,17/04/2021
4,7,3,0,Sikkim,0,7,7,12561,7,6,3,0,18/01/2021
5962,9981,4019,358,Sikkim,109,9872,10339,25071,9981,250,35,0,18/02/2021
20896,48233,27332,9155,Sikkim,226,48007,57388,55692,48233,1556,150,5,18/03/2021
64859,140119,75242,20939,Sikkim,0,161058,161058,140119,140119,5750,31,18,18/04/2021
24,38,14,0,Sikkim,0,38,38,16024,38,22,4,0,19/01/2021
6467,11296,4829,697,Sikkim,124,11172,11993,25727,11296,253,35,0,19/02/2021
21851,50203,28347,9698,Sikkim,226,49977,59901,57755,50203,1570,153,5,19/03/2021
66615,143952,77319,22657,Sikkim,0,166609,166609,143952,143952,12350,67,18,19/04/2021
38,62,24,0,Sikkim,0,62,62,16457,62,26,5,0,20/01/2021
6681,12222,5541,699,Sikkim,128,12094,12921,25733,12222,257,35,0,20/02/2021
22504,51619,29110,10114,Sikkim,226,51393,61733,58997,51619,1639,154,5,20/03/2021
67938,146868,78909,24255,Sikkim,0,171123,171123,146868,146868,13050,66,21,20/04/2021
114,186,72,0,Sikkim,0,186,186,18554,186,30,6,0,21/01/2021
6681,12222,5541,699,Sikkim,128,12094,12921,25776,12222,282,36,0,21/02/2021
22529,51689,29155,10121,Sikkim,226,51463,61810,59000,51689,1674,154,5,21/03/2021
68357,147787,79409,24678,Sikkim,0,172465,172465,147787,147787,8350,41,21,21/04/2021
175,296,121,0,Sikkim,0,296,296,18697,296,32,6,0,22/01/2021
23290,53294,29999,11292,Sikkim,226,53068,64586,60643,53294,1694,155,5,22/03/2021
69361,149886,80504,27276,Sikkim,0,177162,177162,149886,149886,13650,74,21,22/04/2021
177,299,122,0,Sikkim,0,299,299,19519,299,32,6,0,23/01/2021
24267,55335,31063,12180,Sikkim,226,55109,67515,62632,55335,1708,155,5,23/03/2021
70477,152278,81780,30343,Sikkim,0,182621,182621,152278,152278,12450,68,21,23/04/2021
183,309,126,0,Sikkim,0,309,309,19556,309,33,7,0,24/01/2021
25086,57067,31976,12545,Sikkim,226,56841,69612,64324,57067,1731,156,5,24/03/2021
71040,153579,82518,31870,Sikkim,0,185449,185449,153579,153579,10400,53,21,24/04/2021
291,477,186,0,Sikkim,0,477,477,19968,477,36,7,0,25/01/2021
25855,58707,32846,12794,Sikkim,226,58481,71501,65942,58707,1926,156,6,25/03/2021
71202,153939,82716,31956,Sikkim,0,185895,185895,153939,153939,4200,21,21,25/04/2021
299,490,191,0,Sikkim,0,490,490,19995,490,42,8,0,26/01/2021
7440,17647,10207,1465,Sikkim,170,17477,19112,25663,17647,343,39,0,26/02/2021
26668,60368,33694,12915,Sikkim,226,60142,73283,67591,60368,1964,156,6,26/03/2021
72026,155696,83649,34257,Sikkim,0,189953,189953,155696,155696,12000,63,21,26/04/2021
606,964,358,0,Sikkim,0,964,964,20233,964,50,10,0,27/01/2021
26679,60402,33717,12923,Sikkim,227,60175,73325,67618,60402,1967,156,6,27/03/2021
72666,157168,84481,36666,Sikkim,0,193834,193834,157168,157168,11380,62,21,27/04/2021
908,1431,523,0,Sikkim,0,1431,1431,20548,1431,55,11,0,28/01/2021
1083,1707,624,0,Sikkim,0,1707,1707,20673,1707,61,13,0,29/01/2021
1083,1707,624,0,Sikkim,0,1707,1707,20687,1707,63,13,0,30/01/2021
27030,61196,34160,13133,Sikkim,228,60968,74329,68419,61196,2006,157,6,30/03/2021
27195,61582,34381,13220,Sikkim,229,61353,74802,68786,61582,2013,157,6,31/03/2021
51872,85002,33125,0,Tamil Nadu,1606,83396,85002,368614,85002,4235,977,5,01/02/2021
1346906,2694050,1346876,260326,Tamil Nadu,388354,2305696,2954376,3220817,2694050,274124,6912,268,01/04/2021
55848,91094,35237,0,Tamil Nadu,1698,89396,91094,378666,91094,4813,1118,9,02/02/2021
177871,315543,137641,42057,Tamil Nadu,5886,309657,357600,815875,315543,33022,2635,31,02/03/2021
1379560,2760742,1380910,269771,Tamil Nadu,398720,2362022,3030513,3286890,2760742,278354,6927,272,02/04/2021
60786,98750,37955,0,Tamil Nadu,1849,96901,98750,387768,98750,5656,1299,9,03/02/2021
195834,353429,157561,47077,Tamil Nadu,6745,346684,400506,854094,353429,46886,2788,34,03/03/2021
1401600,2806398,1404517,277561,Tamil Nadu,405073,2401325,3083959,3334842,2806398,282668,6942,281,03/04/2021
66602,107904,41292,0,Tamil Nadu,1966,105938,107904,403686,107904,6503,1376,10,04/02/2021
221534,404222,182650,51387,Tamil Nadu,7946,396276,455609,907803,404222,53106,2864,38,04/03/2021
1419242,2855222,1435695,286662,Tamil Nadu,423427,2718457,3141884,2855222,2855222,550710,4079,285,04/04/2021
72221,116857,44626,0,Tamil Nadu,2076,114781,116857,418848,116857,7213,1424,10,05/02/2021
256643,474441,217754,57713,Tamil Nadu,9590,464851,532154,979994,474441,57741,2946,44,05/03/2021
1437337,2892174,1454548,294913,Tamil Nadu,429313,2757774,3187087,2892174,2892174,625230,4692,289,05/04/2021
78231,126381,48140,0,Tamil Nadu,2311,124070,126381,442401,126381,7579,1442,10,06/02/2021
295856,554443,258536,65172,Tamil Nadu,11737,542706,619615,1057355,554443,64212,3033,51,06/03/2021
1450465,2918808,1468052,300551,Tamil Nadu,434314,2785045,3219359,2918808,2918808,606290,4595,291,06/04/2021
78781,127289,48498,0,Tamil Nadu,2311,124978,127289,456537,127289,8007,1478,10,07/02/2021
308034,579008,270919,67333,Tamil Nadu,12594,566414,646341,1082885,579008,66142,3057,55,07/03/2021
1474497,2967647,1492854,312890,Tamil Nadu,443519,2837018,3280537,2967647,2967647,636020,4829,296,07/04/2021
85898,139024,53116,0,Tamil Nadu,2815,136209,139024,474795,139024,8838,1536,10,08/02/2021
348156,658443,310214,73749,Tamil Nadu,14584,643859,732192,1163427,658443,68867,3104,73,08/03/2021
1519910,3061151,1540934,339773,Tamil Nadu,459339,2941585,3400924,3061151,3061151,639010,4932,307,08/04/2021
92426,150915,58479,0,Tamil Nadu,2913,148002,150915,497445,150915,9608,1558,10,09/02/2021
387964,735507,347461,81904,Tamil Nadu,16404,719103,817411,1241061,735507,73510,3152,82,09/03/2021
1568125,3166812,1598360,365634,Tamil Nadu,475882,3056564,3532446,3166812,3166812,661150,5057,327,09/04/2021
98700,162412,63699,0,Tamil Nadu,3016,159396,162412,524454,162412,10408,1582,13,10/02/2021
432771,823553,390693,90676,Tamil Nadu,18669,804884,914229,1329421,823553,89765,3697,89,10/03/2021
1616775,3274164,1657055,391131,Tamil Nadu,492256,3173039,3665295,3274164,3274164,628960,4861,334,10/04/2021
105160,173368,68191,0,Tamil Nadu,3098,170270,173368,549595,173368,11199,1610,17,11/02/2021
473773,906064,432193,99899,Tamil Nadu,21102,884962,1005963,1411955,906064,121477,4542,98,11/03/2021
1635052,3316055,1680666,398627,Tamil Nadu,500185,3214497,3714682,3316055,3316055,617770,4769,337,11/04/2021
111679,184565,72869,0,Tamil Nadu,3178,181387,184565,579354,184565,12035,1620,17,12/02/2021
520396,996011,475507,109253,Tamil Nadu,23728,972283,1105264,1502464,996011,138372,4676,108,12/03/2021
1695027,3449290,1753902,430938,Tamil Nadu,517200,3363028,3880228,3449290,3449290,654291,5133,361,12/04/2021
117117,195203,78068,667,Tamil Nadu,3379,191824,195870,609592,195203,12436,1632,18,13/02/2021
565842,1085084,519128,119139,Tamil Nadu,27081,1058003,1204223,1591321,1085084,145000,4727,114,13/03/2021
1743614,3565954,1821956,453372,Tamil Nadu,532413,3486913,4019326,3565954,3565954,660880,5169,384,13/04/2021
117439,195796,78339,671,Tamil Nadu,3379,192417,196467,627427,195796,12924,1638,18,14/02/2021
576406,1107059,530538,120732,Tamil Nadu,28131,1078928,1227791,1611984,1107059,147653,4739,115,14/03/2021
1774045,3641043,1866609,469082,Tamil Nadu,542671,3567454,4110125,3641043,3641043,648770,5096,389,14/04/2021
122027,203921,81876,1176,Tamil Nadu,3566,200355,205097,656573,203921,13699,1660,18,15/02/2021
624891,1203570,578557,129022,Tamil Nadu,32257,1171313,1332592,1711388,1203570,158010,4853,122,15/03/2021
1847635,3801731,1953686,514054,Tamil Nadu,563954,3751831,4315785,3801731,3801731,673000,5229,410,15/04/2021
545,1167,622,0,Tamil Nadu,6,1161,1167,252156,1167,191,149,0,16/01/2021
127295,213823,86510,2141,Tamil Nadu,3673,210150,215964,717140,213823,14633,1680,18,16/02/2021
677663,1308844,631050,140238,Tamil Nadu,38704,1270140,1449082,1817684,1308844,169684,4990,131,16/03/2021
1922344,3966587,2043812,562249,Tamil Nadu,590463,3938373,4528836,3966587,3966587,664911,5249,431,16/04/2021
759,1745,986,0,Tamil Nadu,29,1716,1745,253957,1745,257,176,0,17/01/2021
132587,224158,91552,3579,Tamil Nadu,3812,220346,227737,803932,224158,15444,1705,19,17/02/2021
732788,1422070,689138,150938,Tamil Nadu,50267,1371803,1573008,1931027,1422070,177009,5100,144,17/03/2021
1967033,4063643,2096168,605401,Tamil Nadu,613357,4055687,4669044,4063643,4063643,621790,4900,442,17/04/2021
1238,2861,1623,0,Tamil Nadu,42,2819,2861,236748,2861,347,201,0,18/01/2021
134445,228388,93924,6024,Tamil Nadu,3805,224583,234412,719427,228388,16283,1718,19,18/02/2021
786162,1532623,746306,161437,Tamil Nadu,66036,1466587,1694060,2044486,1532623,181273,5277,155,18/03/2021
1979559,4090953,2110947,619909,Tamil Nadu,624338,4086524,4710862,4090953,4090953,637202,5010,447,18/04/2021
3047,6154,3106,0,Tamil Nadu,111,6043,6154,251767,6154,483,239,1,19/01/2021
144574,246203,101610,10185,Tamil Nadu,4198,242005,256388,894680,246203,17079,1759,19,19/02/2021
835522,1634788,799101,171773,Tamil Nadu,85294,1549494,1806561,2151335,1634788,188631,5646,165,19/03/2021
2005846,4147072,2140772,666304,Tamil Nadu,654271,4159105,4813376,4147072,4147072,668830,5279,454,19/04/2021
4644,9060,4415,0,Tamil Nadu,144,8916,9060,260013,9060,695,301,1,20/01/2021
149587,255918,106312,13955,Tamil Nadu,4417,251501,269873,897273,255918,17628,1825,19,20/02/2021
891796,1749437,857466,182635,Tamil Nadu,114712,1634725,1932072,2266424,1749437,199506,5996,175,20/03/2021
2024108,4187565,2162999,704499,Tamil Nadu,682404,4209660,4892064,4187565,4187565,674276,5337,458,20/04/2021
8535,15654,7117,0,Tamil Nadu,227,15427,15654,265778,15654,915,353,2,21/01/2021
149887,256365,106459,14122,Tamil Nadu,4421,251944,270487,897493,256365,18094,1825,19,21/02/2021
912757,1792835,879900,186177,Tamil Nadu,133349,1659486,1979012,2306503,1792835,205733,6109,178,21/03/2021
2040308,4223251,2182481,742313,Tamil Nadu,708301,4257263,4965564,4223251,4223251,668784,5300,462,21/04/2021
13501,23659,10156,0,Tamil Nadu,355,23304,23659,275975,23659,1116,385,2,22/01/2021
152972,262213,109222,18634,Tamil Nadu,4579,257634,280847,898199,262213,18914,1841,19,22/02/2021
954885,1881107,926039,194378,Tamil Nadu,161936,1719171,2075485,2403939,1881107,213853,6258,183,22/03/2021
2061619,4268889,2206806,806792,Tamil Nadu,728203,4347478,5075681,4268889,4268889,679124,5384,464,22/04/2021
18156,31127,12969,0,Tamil Nadu,510,30617,31127,283972,31127,1302,412,2,23/01/2021
156254,268486,112212,23096,Tamil Nadu,4696,263790,291582,900706,268486,19920,1848,20,23/02/2021
1012651,2002616,989770,204775,Tamil Nadu,209846,1792770,2207391,2520924,2002616,218520,6369,195,23/03/2021
2086468,4323326,2236387,882230,Tamil Nadu,745060,4460496,5205556,4323326,4323326,675120,5380,471,23/04/2021
20627,35144,14515,0,Tamil Nadu,591,34553,35144,287898,35144,1498,437,2,24/01/2021
158671,273618,114927,26986,Tamil Nadu,4813,268805,300604,902629,273618,20826,1860,20,24/02/2021
1056946,2096441,1039296,210589,Tamil Nadu,251172,1845269,2307030,2614757,2096441,223274,6518,199,24/03/2021
2110488,4376661,2265694,951254,Tamil Nadu,757930,4569985,5327915,4376661,4376661,617336,4927,479,24/04/2021
24413,41396,16981,0,Tamil Nadu,740,40656,41396,297930,41396,1805,511,2,25/01/2021
160925,278432,117487,30463,Tamil Nadu,4975,273457,308895,904401,278432,21807,1874,20,25/02/2021
1104169,2195684,1091306,216779,Tamil Nadu,287662,1908022,2412463,2714674,2195684,227855,6619,209,25/03/2021
2115700,4388384,2272205,962689,Tamil Nadu,761022,4590051,5351073,4388384,4388384,604336,4852,479,25/04/2021
27468,46310,18840,0,Tamil Nadu,896,45414,46310,301648,46310,2135,600,2,26/01/2021
163867,284640,120753,35326,Tamil Nadu,5222,279418,319966,786052,284640,22357,1884,20,26/02/2021
1151093,2294568,1143249,223748,Tamil Nadu,314443,1980125,2518316,2814751,2294568,232427,6689,226,26/03/2021
2139949,4440291,2299858,1043041,Tamil Nadu,783406,4699926,5483332,4440291,4440291,645676,5199,484,26/04/2021
32443,54195,21749,0,Tamil Nadu,1085,53110,54195,309492,54195,2558,697,3,27/01/2021
163867,284640,120753,35326,Tamil Nadu,5222,279418,319966,786053,284640,22357,1884,20,27/02/2021
1198096,2392185,1193849,229461,Tamil Nadu,336835,2055350,2621646,2911323,2392185,237315,6739,240,27/03/2021
2165375,4495630,2329760,1129102,Tamil Nadu,814748,4809984,5624732,4495630,4495630,640116,5195,495,27/04/2021
36828,61290,24459,0,Tamil Nadu,1247,60043,61290,318570,61290,2911,774,3,28/01/2021
163867,284640,120753,35326,Tamil Nadu,5222,279418,319966,786054,284640,22783,1933,20,28/02/2021
1207816,2412339,1204282,230272,Tamil Nadu,341575,2070764,2642611,2931606,2412339,240745,6742,241,28/03/2021
40326,66918,26589,0,Tamil Nadu,1331,65587,66918,337176,66918,3280,822,3,29/01/2021
1251872,2500855,1248731,236963,Tamil Nadu,357376,2143479,2737818,3021565,2500855,246942,6779,252,29/03/2021
46835,76934,30095,0,Tamil Nadu,1495,75439,76934,352069,76934,3505,831,4,30/01/2021
1287225,2572314,1284828,244484,Tamil Nadu,369020,2203294,2816798,3094170,2572314,252742,6843,261,30/03/2021
47384,77809,30421,0,Tamil Nadu,1505,76304,77809,358336,77809,3812,876,4,31/01/2021
1320108,2638844,1318471,253010,Tamil Nadu,380277,2258567,2891854,3161769,2638844,262875,6877,265,31/03/2021
53748,95234,41476,0,Telangana,0,95234,95234,382595,95234,4727,1669,10,01/02/2021
419755,899306,479453,238581,Telangana,138060,761246,1137887,1243832,899306,51776,3244,98,01/04/2021
54270,96413,42133,0,Telangana,1,96412,96413,387918,96413,4895,1702,10,02/02/2021
143676,297234,153542,129321,Telangana,44097,253137,426555,629001,297234,15224,2782,16,02/03/2021
442176,947571,505289,241917,Telangana,141240,806331,1189488,1291576,947571,54996,3252,106,02/04/2021
57656,103183,45517,0,Telangana,1,103182,103183,401998,103183,5063,1736,10,03/02/2021
147688,306322,158617,132292,Telangana,44102,262220,438614,638100,306322,16911,2887,17,03/03/2021
460425,986025,525489,245253,Telangana,143499,842526,1231278,1335543,986025,57192,3258,111,03/04/2021
63262,114647,51375,0,Telangana,1,114646,114647,419963,114647,5307,1800,10,04/02/2021
155131,322444,167296,140364,Telangana,44138,278306,462808,654434,322444,17916,2932,17,04/03/2021
576047,1227030,650825,251833,Telangana,205151,1273712,1478863,1227030,1227030,144101,1070,158,04/04/2021
66718,121588,54860,0,Telangana,1,121587,121588,436569,121588,5926,1937,10,05/02/2021
163716,341073,177334,147131,Telangana,44154,296919,488204,673714,341073,20293,2957,23,05/03/2021
601131,1278480,677183,256353,Telangana,208067,1326766,1534833,1278480,1278480,168210,1222,166,05/04/2021
68012,135977,67955,0,Telangana,1,135976,135977,453739,135977,6363,2010,10,06/02/2021
172138,362082,189920,158716,Telangana,44800,317282,520798,695099,362082,23030,2964,24,06/03/2021
618428,1313584,694979,260027,Telangana,210995,1362616,1573611,1313584,1313584,172291,1256,177,06/04/2021
68062,136225,68153,0,Telangana,1,136224,136225,455795,136225,6621,2062,10,07/02/2021
172908,363597,190665,158772,Telangana,44819,318778,522369,696703,363597,23801,2985,24,07/03/2021
662719,1405944,743023,270076,Telangana,220900,1455120,1676020,1405944,1405944,168246,1209,202,07/04/2021
70156,156285,86119,0,Telangana,604,155681,156285,477414,156285,7083,2115,10,08/02/2021
184006,389985,205948,171242,Telangana,45900,344085,561227,723278,389985,25229,2992,31,08/03/2021
710538,1504570,793811,278547,Telangana,232662,1550455,1783117,1504570,1504570,203055,1380,221,08/04/2021
71523,171308,99775,0,Telangana,7469,163839,171308,495923,171308,7634,2221,10,09/02/2021
191929,409292,217332,183254,Telangana,52541,356751,592546,742951,409292,26442,3010,31,09/03/2021
761168,1611380,849966,286802,Telangana,243555,1654627,1898182,1611380,1611380,204671,1352,246,09/04/2021
73127,186195,113058,0,Telangana,18190,168005,186195,522651,186195,8037,2274,10,10/02/2021
198829,426556,227694,192024,Telangana,55405,371151,618580,760354,426556,27179,3047,33,10/03/2021
827126,1763427,936035,296498,Telangana,248890,1811035,2059925,1763427,1763427,191175,1286,266,10/04/2021
74863,198677,123802,0,Telangana,27865,170812,198677,552921,198677,8463,2414,12,11/02/2021
200440,429929,229454,192279,Telangana,55900,374029,622208,763728,429929,28083,3073,35,11/03/2021
871070,1861282,989927,299904,Telangana,251212,1909974,2161186,1861282,1861282,187310,1252,285,11/04/2021
76657,206864,130195,0,Telangana,34949,171915,206864,585234,206864,8808,2439,12,12/02/2021
207993,448865,240833,205043,Telangana,60673,388192,653908,782707,448865,28961,3092,39,12/03/2021
923010,1982573,1059265,309467,Telangana,257338,2034702,2292040,1982573,1982573,202400,1337,298,12/04/2021
78406,209790,131372,1929,Telangana,35849,173941,211719,611344,209790,9191,2443,12,13/02/2021
214505,463121,248576,208082,Telangana,63345,399776,671203,797110,463121,30212,3096,40,13/03/2021
933078,2006982,1073604,311169,Telangana,258492,2059659,2318151,2006982,2006982,172425,1190,300,13/04/2021
78668,210201,131521,2337,Telangana,35849,174352,212538,612633,210201,9451,2468,12,14/02/2021
215448,464868,249379,208103,Telangana,63472,401396,672971,798878,464868,30978,3099,41,14/03/2021
996466,2129490,1132706,323121,Telangana,267499,2185112,2452611,2129490,2129490,201865,1299,318,14/04/2021
86191,219843,133640,11479,Telangana,36119,183724,231322,614326,219843,10241,2472,12,15/02/2021
228057,491811,263711,212555,Telangana,68335,423476,704366,826369,491811,31835,3107,43,15/03/2021
1076217,2283343,1206760,338492,Telangana,301224,2320611,2621835,2283343,2283343,202175,1338,366,15/04/2021
146,317,171,0,Telangana,0,317,317,202313,317,111,102,0,16/01/2021
112287,250141,137842,40856,Telangana,36507,213634,290997,618696,250141,10625,2474,12,16/02/2021
236831,511368,274493,214981,Telangana,72106,439262,726349,845865,511368,33008,3116,44,16/03/2021
1159471,2447626,1287765,354437,Telangana,405112,2396951,2802063,2447626,2447626,224375,1470,390,16/04/2021
222,437,215,0,Telangana,0,437,437,214230,437,528,326,0,17/01/2021
112672,250649,137965,41264,Telangana,36593,214056,291913,618809,250649,11060,2474,12,17/02/2021
245827,530631,284758,216166,Telangana,75915,454716,746797,865005,530631,34082,3125,46,17/03/2021
1228196,2584964,1356334,367281,Telangana,499940,2452305,2952245,2584964,2584964,208595,1370,434,17/04/2021
1329,2463,1133,0,Telangana,0,2463,2463,231406,2463,1206,708,1,18/01/2021
122596,260486,137878,64934,Telangana,36703,223783,325420,616189,260486,11506,2475,12,18/02/2021
257410,555059,297600,217412,Telangana,79997,475062,772471,889650,555059,34918,3130,49,18/03/2021
1231219,2591096,1359441,369106,Telangana,504773,2455429,2960202,2591096,2591096,92975,675,436,18/04/2021
6528,11169,4640,0,Telangana,0,11169,11169,245019,11169,1600,887,1,19/01/2021
135280,276506,141212,78781,Telangana,36962,239544,355287,623064,276506,11740,2479,14,19/02/2021
266977,575846,308819,218554,Telangana,83581,492265,794400,911348,575846,35972,3138,50,19/03/2021
1311035,2742005,1430494,390535,Telangana,518477,2614063,3132540,2742005,2742005,206150,1415,476,19/04/2021
6640,11291,4650,0,Telangana,0,11291,11291,249397,11291,2332,1009,1,20/01/2021
135757,277517,141746,79662,Telangana,37473,240044,357179,623538,277517,11979,2483,14,20/02/2021
278361,599339,320925,219843,Telangana,88580,510759,819182,934858,599339,37090,3146,53,20/03/2021
1371160,2861258,1489601,410841,Telangana,539310,2732789,3272099,2861258,2861258,204300,1305,497,20/04/2021
12132,17837,5704,0,Telangana,0,17837,17837,268478,17837,2893,1053,1,21/01/2021
279835,602369,322479,219958,Telangana,89481,512888,822327,937407,602369,38186,3149,55,21/03/2021
1422408,2965467,1542539,429176,Telangana,551525,2843118,3394643,2965467,2965467,198015,1380,520,21/04/2021
17671,24830,7158,0,Telangana,0,24830,24830,289574,24830,2985,1057,1,22/01/2021
136375,278786,142397,97476,Telangana,37595,241191,376262,623642,278786,12386,2485,14,22/02/2021
293748,631485,337675,221282,Telangana,94053,537432,852767,969828,631485,39616,3155,62,22/03/2021
1519396,3148315,1628321,456271,Telangana,561611,3042975,3604586,3148315,3148315,232855,1474,598,22/04/2021
18347,26183,7835,0,Telangana,0,26183,26183,294222,26183,3133,1102,1,23/01/2021
136513,279390,142863,98321,Telangana,38104,241286,377711,623676,279390,12712,2488,14,23/02/2021
307853,661704,353785,223215,Telangana,99885,561819,884919,997820,661704,40493,3157,66,23/03/2021
1615538,3332501,1716318,479360,Telangana,571385,3240476,3811861,3332501,3332501,214731,1450,645,23/04/2021
19546,27829,8282,0,Telangana,0,27829,27829,299174,27829,3577,1366,1,24/01/2021
136894,281009,144101,98354,Telangana,39717,241292,379363,623686,281009,13149,2508,14,24/02/2021
321201,690164,368893,224041,Telangana,106616,583548,914205,1026808,690164,41568,3165,70,24/03/2021
1701884,3500047,1797477,503781,Telangana,580553,3423275,4003828,3500047,3500047,199705,1389,686,24/04/2021
30738,50646,19905,0,Telangana,0,50646,50646,321083,50646,3669,1390,3,25/01/2021
138128,283924,145782,116470,Telangana,41174,242750,400394,623854,283924,13814,2613,14,25/02/2021
336288,722653,386291,226443,Telangana,113011,609642,949096,1059711,722653,42562,3173,74,25/03/2021
1731547,3559142,1826899,512327,Telangana,582589,3488880,4071469,3559142,3559142,135990,977,696,25/04/2021
31120,51194,20071,0,Telangana,0,51194,51194,325924,51194,3769,1432,3,26/01/2021
141004,291425,150405,127664,Telangana,44096,247329,419089,622829,291425,14012,2673,16,26/02/2021
352038,756073,403959,229581,Telangana,119709,636364,985654,1093577,756073,43347,3189,76,26/03/2021
1829888,3744656,1914027,542319,Telangana,589584,3697391,4286975,3744656,3744656,203525,1418,741,26/04/2021
36793,58306,21510,0,Telangana,0,58306,58306,329181,58306,4211,1563,3,27/01/2021
365625,784765,419060,230552,Telangana,125585,659180,1015317,1122527,784765,44194,3197,80,27/03/2021
1876080,3837190,1960354,562813,Telangana,598594,3801409,4400003,3837190,3837190,161530,1166,756,27/04/2021
45978,78713,32727,0,Telangana,0,78713,78713,348293,78713,4462,1610,8,28/01/2021
141004,291425,150405,127664,Telangana,44096,247329,419089,622830,291425,14355,2697,16,28/02/2021
366262,786087,419745,230579,Telangana,125803,660284,1016666,1123630,786087,44805,3197,80,28/03/2021
52409,92418,39999,0,Telangana,0,92418,92418,367255,92418,4510,1623,10,29/01/2021
370831,795583,424672,230789,Telangana,128209,667374,1026372,1133366,795583,45765,3201,80,29/03/2021
53630,95000,41360,0,Telangana,0,95000,95000,376538,95000,4566,1629,10,30/01/2021
387858,831422,443482,233150,Telangana,131773,699649,1064572,1170007,831422,46780,3211,82,30/03/2021
53668,95057,41379,0,Telangana,0,95057,95057,378257,95057,4610,1636,10,31/01/2021
400706,858398,457606,235601,Telangana,134535,723863,1093999,1197834,858398,48688,3227,86,31/03/2021
18475,22996,4521,0,Tripura,0,22996,22996,72793,22996,865,166,0,01/02/2021
292000,615647,323574,78662,Tripura,114,615533,694309,655059,615647,26889,1027,73,01/04/2021
19285,24202,4917,0,Tripura,0,24202,24202,73965,24202,923,167,0,02/02/2021
36028,92853,56823,23582,Tripura,52,92801,116435,117498,92853,3447,333,2,02/03/2021
297836,626740,328831,79483,Tripura,116,626624,706223,665383,626740,27180,1027,73,02/04/2021
19469,24413,4944,0,Tripura,0,24413,24413,74333,24413,1000,173,0,03/02/2021
36652,94340,57686,24774,Tripura,52,94288,119114,118909,94340,3758,355,2,03/03/2021
303392,637582,334114,80699,Tripura,130,637452,718281,676944,637582,27752,1027,76,03/04/2021
21594,27081,5487,0,Tripura,0,27081,27081,76133,27081,1072,186,0,04/02/2021
38763,99422,60657,26322,Tripura,52,99370,125744,123738,99422,4246,356,2,04/03/2021
308636,645348,336636,79823,Tripura,0,725171,725171,645348,645348,39600,193,76,04/04/2021
22888,29402,6514,0,Tripura,0,29402,29402,78734,29402,1175,202,0,05/02/2021
41086,104553,63465,28254,Tripura,53,104500,132807,128961,104553,4454,359,2,05/03/2021
315112,657921,342733,81952,Tripura,0,739873,739873,657921,657921,105000,622,76,05/04/2021
23862,32235,8373,0,Tripura,0,32235,32235,80746,32235,1243,216,0,06/02/2021
42072,106718,64644,28934,Tripura,55,106663,135652,131174,106718,4591,366,2,06/03/2021
320818,668678,347782,83035,Tripura,0,751713,751713,668678,668678,73950,404,78,06/04/2021
23906,32289,8383,0,Tripura,0,32289,32289,81134,32289,1297,229,0,07/02/2021
42074,106720,64644,28937,Tripura,55,106665,135657,131176,106720,4690,371,2,07/03/2021
326691,680375,353604,84576,Tripura,0,764951,764951,680375,680375,67600,421,80,07/04/2021
24653,37310,12657,0,Tripura,0,37310,37310,83281,37310,1399,253,0,08/02/2021
44952,113725,68770,32682,Tripura,65,113660,146407,138077,113725,5111,375,3,08/03/2021
335490,698009,362436,87409,Tripura,0,785418,785418,698009,698009,101050,633,83,08/04/2021
25751,42999,17248,0,Tripura,0,42999,42999,86446,42999,1477,266,0,09/02/2021
47066,119487,72416,36944,Tripura,68,119419,156431,143740,119487,5578,377,5,09/03/2021
342668,712932,370179,89808,Tripura,0,802740,802740,712932,712932,105200,714,85,09/04/2021
26042,45158,19116,0,Tripura,0,45158,45158,88189,45158,1560,276,0,10/02/2021
47459,120654,73190,38049,Tripura,73,120581,158703,144872,120654,7144,410,5,10/03/2021
346660,720930,374184,91265,Tripura,0,812195,812195,720930,720930,98680,631,86,10/04/2021
26767,51453,24686,0,Tripura,0,51453,51453,91762,51453,1669,284,0,11/02/2021
47746,121576,73825,39160,Tripura,76,121500,160736,145744,121576,7851,424,5,11/03/2021
349831,727172,377253,91875,Tripura,0,819047,819047,727172,727172,98600,672,88,11/04/2021
27365,57389,30024,0,Tripura,4,57385,57389,95833,57389,1752,292,0,12/02/2021
50574,129975,79395,45229,Tripura,76,129899,175204,154121,129975,8154,451,6,12/03/2021
354995,737653,382569,95157,Tripura,0,832810,832810,737653,737653,111300,747,89,12/04/2021
27781,61510,33729,334,Tripura,6,61504,61844,98802,61510,1793,295,0,13/02/2021
51509,132645,81130,47554,Tripura,76,132569,180199,156689,132645,8325,500,6,13/03/2021
358350,744903,386463,97423,Tripura,0,842326,842326,744903,744903,110100,716,90,13/04/2021
27781,61525,33744,334,Tripura,6,61519,61859,100453,61525,1857,297,0,14/02/2021
51667,132945,81272,47576,Tripura,76,132869,180521,157000,132945,8519,545,6,14/03/2021
359224,746994,387678,98151,Tripura,0,845145,845145,746994,746994,99950,663,92,14/04/2021
28979,66987,38008,1510,Tripura,10,66977,68497,103858,66987,1905,298,0,15/02/2021
57951,148233,90275,54398,Tripura,77,148156,202631,172550,148233,9306,603,7,15/03/2021
359273,747073,387708,98224,Tripura,0,845297,845297,747073,747073,83200,560,92,15/04/2021
59,107,48,0,Tripura,0,107,107,28896,107,21,18,0,16/01/2021
28984,67171,38187,1510,Tripura,17,67154,68681,106190,67171,1958,299,0,16/02/2021
64779,163129,98340,57850,Tripura,79,163050,220979,188224,163129,10390,709,10,16/03/2021
363774,756408,392541,106053,Tripura,0,862461,862461,756408,756408,110400,692,93,16/04/2021
59,107,48,0,Tripura,0,107,107,28899,107,72,41,0,17/01/2021
29736,69698,39962,2376,Tripura,20,69678,72074,108506,69698,2084,300,0,17/02/2021
68848,171547,102688,58853,Tripura,79,171468,230400,196635,171547,11087,807,11,17/03/2021
368543,766208,397569,113976,Tripura,0,880184,880184,766208,766208,104050,668,96,17/04/2021
159,230,71,0,Tripura,0,230,230,31113,230,114,65,0,18/01/2021
29512,72899,43387,6761,Tripura,28,72871,79660,107200,72899,2200,300,0,18/02/2021
81101,197169,116055,62265,Tripura,79,197090,259434,222812,197169,12639,846,13,18/03/2021
370092,769465,399276,116601,Tripura,0,886066,886066,769465,769465,95150,634,97,18/04/2021
467,681,214,0,Tripura,0,681,681,38013,681,144,75,0,19/01/2021
33387,79570,46183,10994,Tripura,30,79540,90564,112850,79570,2280,300,0,19/02/2021
94575,224576,129987,65161,Tripura,79,224497,289737,252031,224576,15465,888,14,19/03/2021
375457,780166,404612,130054,Tripura,0,910220,910220,780166,780166,106250,708,97,19/04/2021
473,687,214,0,Tripura,0,687,687,39677,687,232,116,0,20/01/2021
33542,80875,47333,11414,Tripura,30,80845,92289,112965,80875,2324,300,0,20/02/2021
106840,249006,142151,66685,Tripura,80,248926,315691,276447,249006,18517,939,15,20/03/2021
380597,790891,410196,142902,Tripura,0,933793,933793,790891,790891,122250,846,98,20/04/2021
1429,1812,383,0,Tripura,0,1812,1812,43531,1812,313,138,0,21/01/2021
112039,259095,147036,66831,Tripura,92,259003,325926,285309,259095,18989,943,20,21/03/2021
382654,794856,412103,146698,Tripura,0,941554,941554,794856,794856,118900,834,99,21/04/2021
2642,3321,679,0,Tripura,0,3321,3321,46174,3321,338,138,0,22/01/2021
33606,82561,48955,14696,Tripura,32,82529,97257,112996,82561,2476,302,0,22/02/2021
126789,289228,162412,69000,Tripura,92,289136,358228,320633,289228,19773,951,27,22/03/2021
385054,799703,414550,153794,Tripura,0,953497,953497,799703,799703,118250,833,99,22/04/2021
2656,3349,693,0,Tripura,0,3349,3349,46505,3349,439,149,0,23/01/2021
33724,84098,50374,15986,Tripura,32,84066,100084,113018,84098,2588,302,0,23/02/2021
152117,339355,187208,71041,Tripura,92,339263,410396,368104,339355,20748,1024,30,23/03/2021
390839,811199,420260,173582,Tripura,0,984781,984781,811199,811199,105710,700,100,23/04/2021
2982,3774,792,0,Tripura,0,3774,3774,46598,3774,447,154,0,24/01/2021
181935,398094,216123,72246,Tripura,97,397997,470340,429531,398094,20965,1027,36,24/03/2021
395505,820575,424969,191246,Tripura,0,1011821,1011821,820575,820575,98350,638,101,24/04/2021
8056,9693,1637,0,Tripura,0,9693,9693,63753,9693,447,154,0,25/01/2021
33962,86553,52591,18915,Tripura,43,86510,105468,113020,86553,2771,304,0,25/02/2021
213885,461163,247231,73575,Tripura,97,461066,534738,493817,461163,21034,1027,47,25/03/2021
397476,824638,427061,196256,Tripura,0,1020894,1020894,824638,824638,67900,386,101,25/04/2021
8259,9946,1687,0,Tripura,0,9946,9946,64562,9946,496,157,0,26/01/2021
34065,88089,54024,21002,Tripura,46,88043,109091,112112,88089,2801,304,0,26/02/2021
247114,527731,280559,74594,Tripura,97,527634,602325,566497,527731,21302,1027,58,26/03/2021
405329,840232,434799,226275,Tripura,0,1066507,1066507,840232,840232,120400,795,104,26/04/2021
10294,12366,2072,0,Tripura,0,12366,12366,64892,12366,621,160,0,27/01/2021
34065,88089,54024,21002,Tripura,46,88043,109091,113103,88089,2801,304,0,27/02/2021
259846,552756,292849,74952,Tripura,97,552659,627708,587926,552756,21399,1027,61,27/03/2021
413487,856586,442987,256674,Tripura,0,1113260,1113260,856586,856586,119150,776,112,27/04/2021
13845,16668,2823,0,Tripura,0,16668,16668,67032,16668,698,163,0,28/01/2021
34065,88089,54024,21002,Tripura,46,88043,109091,113104,88089,2911,314,0,28/02/2021
263623,560484,296800,75019,Tripura,97,560387,635503,595241,560484,21511,1027,61,28/03/2021
15987,19513,3526,0,Tripura,0,19513,19513,69413,19513,747,164,0,29/01/2021
264374,562057,297622,75031,Tripura,97,561960,637088,596808,562057,21609,1027,61,29/03/2021
17349,21342,3993,0,Tripura,0,21342,21342,70902,21342,757,164,0,30/01/2021
277478,587496,309952,76432,Tripura,97,587399,663928,624466,587496,22502,1027,66,30/03/2021
17364,21367,4003,0,Tripura,0,21367,21367,71237,21367,803,166,0,31/01/2021
283718,599509,315721,77396,Tripura,108,599401,676905,636839,599509,25729,1027,70,31/03/2021
1988180,4007469,2018845,596253,Updated On,942285,3661437,4603722,4007469,4007469,111751,811,444,16/04/2021
302224,434549,132288,0,Uttar Pradesh,5469,429080,434549,1090577,434549,10612,3672,37,01/02/2021
1964126,4674077,2709475,1037215,Uttar Pradesh,448858,4225219,5711292,5135306,4674077,206094,13033,476,01/04/2021
302891,435502,132574,0,Uttar Pradesh,5469,430033,435502,1091294,435502,10999,3803,37,02/02/2021
544010,1294029,749939,387630,Uttar Pradesh,207913,1086116,1681659,1698315,1294029,31863,7088,80,02/03/2021
2108610,4989304,2880182,1054556,Uttar Pradesh,501500,4487804,6043860,5460880,4989304,239840,13282,512,02/04/2021
302965,435645,132643,0,Uttar Pradesh,5469,430176,435645,1097156,435645,11474,3946,37,03/02/2021
544321,1295029,750628,387638,Uttar Pradesh,208073,1086956,1682667,1699086,1295029,38032,8002,80,03/03/2021
2205262,5202499,2996701,1065229,Uttar Pradesh,532918,4669581,6267728,5680477,5202499,272452,13452,536,03/04/2021
382272,555622,173304,0,Uttar Pradesh,6369,549253,555622,1127953,555622,11579,3985,46,04/02/2021
575662,1365655,789904,458641,Uttar Pradesh,209637,1156018,1824296,1771180,1365655,42224,8444,89,04/03/2021
2416985,5663490,3245840,1073973,Uttar Pradesh,729257,6008206,6737463,5663490,5663490,333989,2093,665,04/04/2021
412566,636917,224300,0,Uttar Pradesh,9096,627821,636917,1170156,636917,11608,3986,51,05/02/2021
616237,1465524,849180,522566,Uttar Pradesh,212206,1253318,1988090,1874223,1465524,47678,8629,107,05/03/2021
2534709,5917539,3382139,1106521,Uttar Pradesh,753963,6270097,7024060,5917539,5917539,1015222,6575,691,05/04/2021
412980,638107,225075,0,Uttar Pradesh,9099,629008,638107,1229787,638107,11624,3987,52,06/02/2021
624204,1485787,861476,529204,Uttar Pradesh,213741,1272046,2014991,1892945,1485787,52850,9063,107,06/03/2021
2666896,6199023,3531382,1141236,Uttar Pradesh,780410,6559849,7340259,6199023,6199023,991848,6399,745,06/04/2021
413089,638805,225664,0,Uttar Pradesh,9099,629706,638805,1256820,638805,11726,4006,52,07/02/2021
625452,1488836,863277,530345,Uttar Pradesh,213834,1275002,2019181,1896178,1488836,61109,9751,107,07/03/2021
2862783,6619721,3756137,1171936,Uttar Pradesh,817628,6974029,7791657,6619721,6619721,841201,5232,801,07/04/2021
413355,640144,226737,0,Uttar Pradesh,9108,631036,640144,1261407,640144,12572,4225,52,08/02/2021
707574,1679720,972019,536991,Uttar Pradesh,215962,1463758,2216711,2093480,1679720,64862,9947,127,08/03/2021
3017373,6950868,3932633,1193098,Uttar Pradesh,846469,7297497,8143966,6950868,6950868,1021432,6571,862,08/04/2021
413405,640845,227388,0,Uttar Pradesh,9126,631719,640845,1262681,640845,14324,4647,52,09/02/2021
720442,1711412,990838,538548,Uttar Pradesh,217393,1494019,2249960,2123902,1711412,81111,10250,132,09/03/2021
3118869,7169348,4049576,1226853,Uttar Pradesh,870313,7525888,8396201,7169348,7169348,926557,6016,903,09/04/2021
413780,643010,229177,0,Uttar Pradesh,9365,633645,643010,1266138,643010,15518,4946,53,10/02/2021
730788,1737105,1006181,539469,Uttar Pradesh,218731,1518374,2276574,2149947,1737105,95589,10579,136,10/03/2021
3158131,7255753,4096709,1238088,Uttar Pradesh,883832,7610009,8493841,7255753,7255753,620384,3911,913,10/04/2021
423786,746208,322369,0,Uttar Pradesh,69526,676682,746208,1345628,746208,15883,5043,53,11/02/2021
733130,1742377,1009111,539846,Uttar Pradesh,219022,1523355,2282223,2155173,1742377,103245,10749,136,11/03/2021
3302238,7558409,4255205,1265684,Uttar Pradesh,894285,7929808,8824093,7558409,7558409,1015818,6532,966,11/04/2021
434964,863157,428140,0,Uttar Pradesh,138967,724190,863157,1436969,863157,16539,5111,53,12/02/2021
827912,1994435,1166348,612327,Uttar Pradesh,239616,1754819,2606762,2413540,1994435,109359,10844,175,12/03/2021
3515475,8013755,4497208,1342857,Uttar Pradesh,907334,8449278,9356612,8013755,8013755,1239796,7811,1072,12/04/2021
435044,864379,429282,2,Uttar Pradesh,139539,724840,864381,1453022,864379,18476,5360,53,13/02/2021
841820,2030532,1188535,621088,Uttar Pradesh,242321,1788211,2651620,2447628,2030532,114525,11032,177,13/03/2021
3651403,8329706,4677156,1388442,Uttar Pradesh,916001,8802147,9718148,8329706,8329706,1177353,7381,1147,13/04/2021
435051,864487,429383,2,Uttar Pradesh,139539,724948,864489,1453275,864487,18807,5415,53,14/02/2021
849073,2046614,1197364,621449,Uttar Pradesh,242692,1803922,2668063,2463733,2046614,118115,11104,177,14/03/2021
3778235,8605823,4826390,1421804,Uttar Pradesh,924425,9103202,10027627,8605823,8605823,1144026,7425,1198,14/04/2021
492680,955423,462664,19788,Uttar Pradesh,143448,811975,975211,1574982,955423,19455,5531,79,15/02/2021
969500,2320717,1351009,668124,Uttar Pradesh,249415,2071302,2988841,2749386,2320717,125569,11193,208,15/03/2021
3858375,8790085,4930473,1482329,Uttar Pradesh,933198,9339216,10272414,8790085,8790085,1039788,6861,1237,15/04/2021
871,2212,1341,0,Uttar Pradesh,55,2157,2212,806592,2212,380,327,0,16/01/2021
493094,956093,462920,19814,Uttar Pradesh,143529,812564,975907,1611944,956093,21314,5864,79,16/02/2021
1026547,2468355,1441587,732806,Uttar Pradesh,271681,2196674,3201161,2890431,2468355,131314,11278,221,16/03/2021
3940518,8978071,5036285,1559991,Uttar Pradesh,953649,9584413,10538062,8978071,8978071,1008852,6563,1268,16/04/2021
879,2224,1345,0,Uttar Pradesh,55,2169,2224,848442,2224,384,330,0,17/01/2021
493107,956274,463088,19814,Uttar Pradesh,143589,812685,976088,1613890,956274,22689,6029,79,17/02/2021
1066071,2565968,1499671,742122,Uttar Pradesh,275762,2290206,3308090,2988262,2565968,134805,11361,226,17/03/2021
3992782,9102301,5108217,1609896,Uttar Pradesh,974094,9738103,10712197,9102301,9102301,881781,5704,1302,17/04/2021
625,1532,907,0,Uttar Pradesh,42,1490,1532,857123,1532,427,338,0,18/01/2021
455637,1034940,579229,19927,Uttar Pradesh,182368,852572,1054867,1586279,1034940,23385,6139,74,18/02/2021
1190421,2879925,1689247,853633,Uttar Pradesh,293063,2586862,3733558,3309440,2879925,137707,11483,257,18/03/2021
3994481,9106335,5110551,1612014,Uttar Pradesh,975462,9742887,10718349,9106335,9106335,481042,3323,1303,18/04/2021
638,1568,930,0,Uttar Pradesh,43,1525,1568,885645,1568,663,431,0,19/01/2021
517041,1135502,618382,98768,Uttar Pradesh,185602,949900,1234270,1688685,1135502,24369,6287,79,19/02/2021
1313905,3165502,1851305,884883,Uttar Pradesh,305930,2859572,4050385,3612289,3165502,141044,11534,292,19/03/2021
4042875,9224739,5180547,1684314,Uttar Pradesh,996628,9912425,10909053,9224739,9224739,927982,6132,1317,19/04/2021
638,1568,930,0,Uttar Pradesh,43,1525,1568,900390,1568,2065,1210,0,20/01/2021
517486,1136590,619024,100271,Uttar Pradesh,185655,950935,1236861,1690723,1136590,26253,6653,80,20/02/2021
1372551,3303203,1930342,895360,Uttar Pradesh,314598,2988605,4198563,3736254,3303203,144813,11611,310,20/03/2021
4094964,9356225,5259926,1764289,Uttar Pradesh,1018393,10102121,11120514,9356225,9356225,953112,6360,1335,20/04/2021
645,1578,933,0,Uttar Pradesh,43,1535,1578,909208,1578,3092,1688,0,21/01/2021
517493,1136650,619077,100709,Uttar Pradesh,185656,950994,1237359,1691675,1136650,26815,6679,80,21/02/2021
1382168,3325510,1943029,896823,Uttar Pradesh,316068,3009442,4222333,3753120,3325510,149495,11834,313,21/03/2021
4134975,9449601,5313227,1809439,Uttar Pradesh,1032111,10226929,11259040,9449601,9449601,983007,6507,1399,21/04/2021
14228,21325,7096,0,Uttar Pradesh,327,20998,21325,950079,21325,3109,1692,1,22/01/2021
527927,1237517,709510,101889,Uttar Pradesh,200220,1037297,1339406,1692241,1237517,28054,6683,80,22/02/2021
1494682,3593203,2098169,954600,Uttar Pradesh,333895,3259308,4547803,4053004,3593203,153253,11935,352,22/03/2021
4184398,9563554,5377729,1877188,Uttar Pradesh,1065189,10375553,11440742,9563554,9563554,1017018,6841,1427,22/04/2021
20343,30644,10300,0,Uttar Pradesh,446,30198,30644,964042,30644,3596,1751,1,23/01/2021
528158,1239758,711520,102272,Uttar Pradesh,200739,1039019,1342030,1692989,1239758,29970,6824,80,23/02/2021
1568318,3767775,2199083,980717,Uttar Pradesh,347888,3419887,4748492,4198941,3767775,155914,11978,374,23/03/2021
4234615,9679629,5443500,1943675,Uttar Pradesh,1095389,10527915,11623304,9679629,9679629,928524,6183,1514,23/04/2021
28714,43669,14952,0,Uttar Pradesh,617,43052,43669,968709,43669,5188,2369,3,24/01/2021
528176,1240045,711789,102273,Uttar Pradesh,200748,1039297,1342318,1693730,1240045,30680,6920,80,24/02/2021
1608912,3867156,2257855,985786,Uttar Pradesh,358282,3508874,4852942,4299082,3867156,158655,12043,389,24/03/2021
4277413,9779700,5500723,1997222,Uttar Pradesh,1114240,10662682,11776922,9779700,9779700,856799,5416,1564,24/04/2021
39501,59780,20276,0,Uttar Pradesh,915,58865,59780,977232,59780,6598,2884,3,25/01/2021
535221,1274807,739506,246737,Uttar Pradesh,205862,1068945,1521544,1693903,1274807,30961,6922,80,25/02/2021
1713141,4107649,2394090,1009980,Uttar Pradesh,377166,3730483,5117629,4541884,4107649,162282,12103,418,25/03/2021
4279015,9783480,5502900,2000449,Uttar Pradesh,1114989,10668940,11783929,9783480,9783480,114165,776,1565,25/04/2021
41513,62477,20961,0,Uttar Pradesh,940,61537,62477,979858,62477,7881,3223,3,26/01/2021
539301,1281076,741696,387553,Uttar Pradesh,206000,1075076,1668629,1684953,1281076,31070,6922,79,26/02/2021
1805022,4311519,2506060,1017710,Uttar Pradesh,394320,3917199,5329229,4750167,4311519,164823,12125,437,26/03/2021
4322917,9883742,5559233,2063635,Uttar Pradesh,1134086,10813291,11947377,9883742,9883742,900143,5822,1592,26/04/2021
63892,95724,31827,0,Uttar Pradesh,1498,94226,95724,984243,95724,8581,3431,5,27/01/2021
1836723,4384984,2547815,1020659,Uttar Pradesh,403129,3981855,5405643,4821279,4384984,167665,12136,446,27/03/2021
4353410,9953817,5598797,2107421,Uttar Pradesh,1153996,10907242,12061238,9953817,9953817,874081,5674,1610,27/04/2021
186025,268081,82036,0,Uttar Pradesh,3516,264565,268081,1032446,268081,8733,3475,20,28/01/2021
539301,1281078,741698,387553,Uttar Pradesh,206000,1075078,1668631,1684956,1281078,31402,7009,79,28/02/2021
1838204,4388132,2549479,1020971,Uttar Pradesh,403681,3984451,5409103,4823422,4388132,169425,12155,449,28/03/2021
298960,429946,130950,0,Uttar Pradesh,5466,424480,429946,1073409,429946,8824,3486,36,29/01/2021
1838205,4388143,2549489,1020977,Uttar Pradesh,403681,3984462,5409120,4823428,4388143,171152,12170,449,29/03/2021
301226,433040,131777,0,Uttar Pradesh,5468,427572,433040,1082471,433040,9585,3563,37,30/01/2021
1849278,4413743,2564014,1021935,Uttar Pradesh,407688,4006055,5435678,4849279,4413743,177020,12260,451,30/03/2021
302023,434185,132125,0,Uttar Pradesh,5469,428716,434185,1086378,434185,10074,3595,37,31/01/2021
1874808,4472639,2597373,1024545,Uttar Pradesh,417376,4055263,5497184,4909450,4472639,192445,12757,458,31/03/2021
20393,32705,12311,0,Uttarakhand,0,32705,32705,108106,32705,1021,236,1,01/02/2021
258222,557334,299066,130745,Uttarakhand,212,557122,688079,605269,557334,24911,1007,46,01/04/2021
25129,39523,14393,0,Uttarakhand,0,39523,39523,110260,39523,1239,272,1,02/02/2021
65671,156016,90340,27057,Uttarakhand,112,155904,183073,201059,156016,4872,421,5,02/03/2021
277990,595772,317734,133823,Uttarakhand,213,595559,729595,643912,595772,26190,1023,48,02/04/2021
33816,50614,16797,0,Uttarakhand,0,50614,50614,115118,50614,1389,280,1,03/02/2021
68000,161695,93689,33037,Uttarakhand,121,161574,194732,206237,161695,5368,433,6,03/03/2021
295872,629898,333978,137328,Uttarakhand,214,629684,767226,680432,629898,27243,1051,48,03/04/2021
40729,59962,19232,0,Uttarakhand,0,59962,59962,120614,59962,1544,288,1,04/02/2021
72117,170995,98872,43015,Uttarakhand,146,170849,214010,215182,170995,5995,436,6,04/03/2021
362588,768440,405763,142991,Uttarakhand,407,911024,911431,768440,768440,83300,366,89,04/04/2021
45332,66129,20796,0,Uttarakhand,0,66129,66129,125534,66129,1658,288,1,05/02/2021
76314,180506,104185,50686,Uttarakhand,151,180355,231192,224644,180506,6765,446,7,05/03/2021
388567,816359,427701,147487,Uttarakhand,407,963439,963846,816359,816359,145120,678,91,05/04/2021
81231,190962,109723,55763,Uttarakhand,153,190809,246725,234879,190962,7466,463,8,06/03/2021
412126,859144,446923,151448,Uttarakhand,407,1010185,1010592,859144,859144,154760,724,95,06/04/2021
48990,71384,22393,0,Uttarakhand,0,71384,71384,137208,71384,1868,320,1,07/02/2021
81418,191538,110112,55909,Uttarakhand,153,191385,247447,235484,191538,7869,467,8,07/03/2021
457072,943113,485930,160089,Uttarakhand,407,1102795,1103202,943113,943113,136340,612,111,07/04/2021
49812,76758,26945,0,Uttarakhand,8,76750,76758,140418,76758,2015,338,1,08/02/2021
86927,204252,117313,61492,Uttarakhand,160,204092,265744,248399,204252,8484,469,12,08/03/2021
496142,1015354,519086,167694,Uttarakhand,407,1182641,1183048,1015354,1015354,161827,735,126,08/04/2021
50733,83729,32994,0,Uttarakhand,39,83690,83729,144823,83729,2183,358,2,09/02/2021
92729,217653,124909,67327,Uttarakhand,162,217491,284980,261465,217653,9057,479,15,09/03/2021
524925,1070092,545031,173811,Uttarakhand,407,1243496,1243903,1070092,1070092,156622,737,136,09/04/2021
51534,89655,38119,0,Uttarakhand,40,89615,89655,152498,89655,2340,370,2,10/02/2021
96758,226268,129494,71652,Uttarakhand,167,226101,297920,270045,226268,10258,492,16,10/03/2021
543289,1105047,561620,179006,Uttarakhand,434,1283619,1284053,1105047,1105047,122500,517,138,10/04/2021
52684,97287,44601,0,Uttarakhand,40,97247,97287,157017,97287,2509,403,2,11/02/2021
97489,227897,130392,72389,Uttarakhand,173,227724,300286,271781,227897,10838,522,16,11/03/2021
555026,1127677,572510,181668,Uttarakhand,434,1308911,1309345,1127677,1127677,97550,433,141,11/04/2021
53599,104337,50736,0,Uttarakhand,40,104297,104337,161418,104337,2624,406,2,12/02/2021
105744,246125,140363,80450,Uttarakhand,176,245949,326575,289997,246125,11486,557,18,12/03/2021
578641,1171473,592678,191003,Uttarakhand,434,1362042,1362476,1171473,1171473,148660,673,154,12/04/2021
54427,109966,55537,403,Uttarakhand,42,109924,110369,166224,109966,2715,408,2,13/02/2021
110903,257226,146303,85593,Uttarakhand,178,257048,342819,300955,257226,12093,562,20,13/03/2021
595778,1205463,609525,198051,Uttarakhand,434,1403080,1403514,1205463,1205463,156100,712,160,13/04/2021
54550,111576,57024,410,Uttarakhand,42,111534,111986,168147,111576,2807,408,2,14/02/2021
111485,258547,147042,86334,Uttarakhand,178,258369,344881,302170,258547,12379,587,20,14/03/2021
607641,1228701,620897,203832,Uttarakhand,434,1432099,1432533,1228701,1228701,136320,635,163,14/04/2021
56032,118110,62076,1651,Uttarakhand,43,118067,119761,173229,118110,2948,409,2,15/02/2021
121080,278688,157587,92749,Uttarakhand,181,278507,371437,322496,278688,13811,645,21,15/03/2021
620661,1254070,633240,213049,Uttarakhand,434,1466685,1467119,1254070,1254070,145370,681,169,15/04/2021
217,511,294,0,Uttarakhand,0,511,511,87193,511,37,33,0,16/01/2021
57473,123162,65686,3042,Uttarakhand,43,123119,126204,179131,123162,3079,410,3,16/02/2021
131471,300386,168888,98556,Uttarakhand,184,300202,398942,344029,300386,15486,669,27,16/03/2021
639659,1291512,651678,227717,Uttarakhand,463,1518766,1519229,1291512,1291512,155260,723,175,16/04/2021
235,556,321,0,Uttarakhand,0,556,556,87546,556,108,42,0,17/01/2021
58387,127874,69484,3351,Uttarakhand,43,127831,131225,188601,127874,3191,411,3,17/02/2021
138360,314897,176509,102332,Uttarakhand,184,314713,417229,358184,314897,16517,701,28,17/03/2021
656235,1324893,668476,241002,Uttarakhand,463,1565432,1565895,1324893,1324893,143800,616,182,17/04/2021
221,517,296,0,Uttarakhand,0,517,517,89234,517,174,47,0,18/01/2021
58212,130669,72454,5039,Uttarakhand,60,130609,135708,182920,130669,3338,412,3,18/02/2021
150036,338807,188741,107060,Uttarakhand,186,338621,445867,382115,338807,16902,719,30,18/03/2021
657268,1326852,669402,241807,Uttarakhand,463,1568196,1568659,1326852,1326852,82150,373,182,18/04/2021
658,1141,483,0,Uttarakhand,0,1141,1141,90819,1141,197,48,0,19/01/2021
60624,136557,75930,7388,Uttarakhand,61,136496,143945,193921,136557,3487,412,3,19/02/2021
161798,362854,201021,110761,Uttarakhand,188,362666,473615,406766,362854,17303,731,35,19/03/2021
677396,1367015,689432,261581,Uttarakhand,463,1628133,1628596,1367015,1367015,158625,774,187,19/04/2021
658,1141,483,0,Uttarakhand,0,1141,1141,91707,1141,257,55,0,20/01/2021
60963,138252,77286,8289,Uttarakhand,69,138183,146541,194451,138252,3564,413,3,20/02/2021
168339,376650,208275,113428,Uttarakhand,188,376462,490078,420043,376650,17964,764,36,20/03/2021
694026,1400819,706600,278182,Uttarakhand,463,1678538,1679001,1400819,1400819,147504,733,193,20/04/2021
1102,1874,772,0,Uttarakhand,0,1874,1874,93093,1874,315,62,0,21/01/2021
61049,138670,77618,8306,Uttarakhand,69,138601,146976,194507,138670,3644,413,3,21/02/2021
169692,379558,209829,113621,Uttarakhand,188,379370,493179,422803,379558,18588,782,37,21/03/2021
707129,1426757,719428,289542,Uttarakhand,463,1715836,1716299,1426757,1426757,142350,716,200,21/04/2021
1905,3163,1258,0,Uttarakhand,0,3163,3163,94119,3163,335,64,0,22/01/2021
61465,140932,79464,10910,Uttarakhand,84,140848,151842,194818,140932,3750,414,3,22/02/2021
181154,402483,221291,116338,Uttarakhand,188,402295,518821,447023,402483,19222,805,38,22/03/2021
725432,1461317,735671,306326,Uttarakhand,463,1767180,1767643,1461317,1461317,150255,789,214,22/04/2021
1946,3238,1292,0,Uttarakhand,0,3238,3238,94640,3238,387,82,0,23/01/2021
61821,143357,81533,12457,Uttarakhand,86,143271,155814,195648,143357,3872,414,3,23/02/2021
192721,425657,232897,118736,Uttarakhand,190,425467,544393,469188,425657,19930,849,39,23/03/2021
741027,1491294,750046,319576,Uttarakhand,516,1810354,1810870,1491294,1491294,138370,694,221,23/04/2021
2121,3592,1471,0,Uttarakhand,0,3592,3592,95537,3592,400,87,0,24/01/2021
62217,144911,82691,12710,Uttarakhand,88,144823,157621,195887,144911,4012,415,3,24/02/2021
200444,441481,240996,120134,Uttarakhand,191,441290,561615,485137,441481,20630,867,41,24/03/2021
755065,1519001,763711,332546,Uttarakhand,711,1850836,1851547,1519001,1519001,133860,623,225,24/04/2021
4982,7969,2987,0,Uttarakhand,0,7969,7969,98713,7969,419,96,0,25/01/2021
62617,146325,83705,15441,Uttarakhand,108,146217,161766,196207,146325,4170,416,3,25/02/2021
211850,464772,252878,121788,Uttarakhand,192,464580,586560,508673,464772,21067,880,44,25/03/2021
761318,1531495,769950,337290,Uttarakhand,833,1867952,1868785,1531495,1531495,117200,544,227,25/04/2021
5050,8052,3002,0,Uttarakhand,0,8052,8052,98949,8052,450,96,0,26/01/2021
62982,148098,85113,20504,Uttarakhand,108,147990,168602,194263,148098,4191,416,3,26/02/2021
223170,487152,263938,123148,Uttarakhand,192,486960,610300,531264,487152,21450,894,44,26/03/2021
778670,1564510,785606,355024,Uttarakhand,1219,1918315,1919534,1564510,1564510,152120,768,234,26/04/2021
5878,9374,3496,0,Uttarakhand,0,9374,9374,99385,9374,514,103,0,27/01/2021
229080,499028,269904,123717,Uttarakhand,201,498827,622745,543073,499028,21727,899,44,27/03/2021
789983,1587147,796926,366043,Uttarakhand,1639,1951551,1953190,1587147,1587147,130350,681,238,27/04/2021
9398,14440,5042,0,Uttarakhand,0,14440,14440,100811,14440,623,145,0,28/01/2021
62982,148100,85115,20504,Uttarakhand,108,147992,168604,194267,148100,4264,417,3,28/02/2021
229211,499294,270039,123741,Uttarakhand,201,499093,623035,543424,499294,21830,899,44,28/03/2021
13896,20864,6967,0,Uttarakhand,0,20864,20864,103350,20864,671,154,1,29/01/2021
15337,23922,8584,0,Uttarakhand,0,23922,23922,104393,23922,772,174,1,30/01/2021
235311,511921,276565,125733,Uttarakhand,201,511720,637654,556172,511921,22969,946,45,30/03/2021
16540,26517,9976,0,Uttarakhand,0,26517,26517,105535,26517,891,204,1,31/01/2021
242425,526352,283881,128272,Uttarakhand,201,526151,654624,570968,526352,24024,990,46,31/03/2021
160810,238178,77261,0,West Bengal,0,238178,238178,983896,238178,5304,759,107,01/02/2021
2046984,4601674,2554185,658257,West Bengal,396060,4205614,5259931,5449457,4601674,175943,5779,505,01/04/2021
173863,259341,85365,0,West Bengal,0,259341,259341,1006832,259341,5757,795,113,02/02/2021
405230,1012276,606914,157761,West Bengal,120556,891720,1170037,2021189,1012276,30738,1547,132,02/03/2021
2121750,4747320,2625058,668788,West Bengal,403551,4343769,5416108,5583923,4747320,179519,5805,512,02/04/2021
181609,271828,90102,0,West Bengal,44,271784,271828,1028696,271828,6267,818,117,03/02/2021
422695,1081891,659059,179460,West Bengal,129822,952069,1261351,2043388,1081891,36318,1786,137,03/03/2021
2195584,4890545,2694433,681014,West Bengal,409353,4481192,5571559,5752030,4890545,182748,5860,528,03/04/2021
193544,290908,97245,0,West Bengal,115,290793,290908,1063690,290908,6632,833,119,04/02/2021
442082,1151159,708931,201021,West Bengal,138714,1012445,1352180,2080689,1151159,41185,2027,146,04/03/2021
2441198,5427490,2985675,720668,West Bengal,556008,5592150,6148158,5427490,5427490,453950,2309,617,04/04/2021
207680,314065,106261,0,West Bengal,185,313880,314065,1120440,314065,7446,846,124,05/02/2021
466385,1226222,759685,222294,West Bengal,147504,1078718,1448516,2133693,1226222,47250,2135,152,05/03/2021
2559453,5657151,3097050,739324,West Bengal,572148,5824327,6396475,5657151,5657151,831225,4350,648,05/04/2021
213639,323825,110061,0,West Bengal,238,323587,323825,1143962,323825,8412,885,125,06/02/2021
492278,1299938,807498,237628,West Bengal,156379,1143559,1537566,2189954,1299938,54156,2396,162,06/03/2021
2676149,5881580,3204767,758183,West Bengal,589806,6049957,6639763,5881580,5881580,701330,3630,664,06/04/2021
213652,323859,110082,0,West Bengal,238,323621,323859,1151102,323859,9612,934,125,07/02/2021
495868,1308982,812952,238471,West Bengal,157046,1151936,1547453,2198265,1308982,64707,2744,162,07/03/2021
2851586,6222811,3370530,797802,West Bengal,626747,6393866,7020613,6222811,6222811,534293,2733,695,07/04/2021
225893,346113,120095,0,West Bengal,688,345425,346113,1181504,346113,10950,953,125,08/02/2021
542933,1424182,881077,260000,West Bengal,167152,1257030,1684182,2302695,1424182,71203,3085,172,08/03/2021
2971542,6465014,3492756,846672,West Bengal,663838,6647848,7311686,6465014,6465014,662418,3304,716,08/04/2021
236688,372621,135808,0,West Bengal,1935,370686,372621,1202929,372621,11398,961,125,09/02/2021
598984,1555051,955886,283056,West Bengal,178475,1376576,1838107,2424037,1555051,76821,3379,181,09/03/2021
3135469,6783892,3647663,889377,West Bengal,710993,6962276,7673269,6783892,6783892,764510,4195,760,09/04/2021
246289,396442,150028,0,West Bengal,3278,393164,396442,1233573,396442,11924,973,125,10/02/2021
648932,1670989,1021860,302753,West Bengal,186381,1484608,1973742,2533006,1670989,83439,3540,197,10/03/2021
3230032,6972586,3741766,918582,West Bengal,753017,7138151,7891168,6972586,6972586,516270,2808,788,10/04/2021
255851,421678,165702,0,West Bengal,4771,416907,421678,1254446,421678,12617,986,125,11/02/2021
673700,1731847,1057942,313451,West Bengal,189905,1541942,2045298,2589249,1731847,87555,3734,205,11/03/2021
3268014,7051017,3782206,931259,West Bengal,776483,7205793,7982276,7051017,7051017,607140,3113,797,11/04/2021
266891,451987,184971,0,West Bengal,7600,444387,451987,1272915,451987,13245,1008,125,12/02/2021
743794,1889627,1145614,338608,West Bengal,199075,1690552,2228235,2742770,1889627,92725,4034,219,12/03/2021
3362932,7241680,3877922,983108,West Bengal,835631,7389157,8224788,7241680,7241680,781951,4132,826,12/04/2021
277587,480743,203029,1084,West Bengal,10798,469945,481827,1293670,480743,13882,1019,127,13/02/2021
791216,1992510,1201057,357809,West Bengal,204539,1787971,2350319,2842276,1992510,98957,4183,237,13/03/2021
3400769,7328009,3926414,1017050,West Bengal,872814,7472245,8345059,7328009,7328009,567710,2976,826,13/04/2021
279120,484229,204982,1136,West Bengal,11774,472455,485365,1304121,484229,14448,1038,127,14/02/2021
796547,2004416,1207632,359632,West Bengal,205295,1799121,2364048,2853468,2004416,104296,4424,237,14/03/2021
3433037,7398413,3964545,1044479,West Bengal,896362,7546530,8442892,7398413,7398413,494751,2493,831,14/04/2021
292779,519678,226771,6240,West Bengal,15762,503916,525918,1433329,519678,15205,1042,128,15/02/2021
893732,2212132,1318127,388295,West Bengal,214892,1997240,2600427,3061289,2212132,109611,4653,273,15/03/2021
3440191,7415379,3974353,1053426,West Bengal,903609,7565196,8468805,7415379,7415379,647120,3331,835,15/04/2021
961,1917,956,0,West Bengal,0,1917,1917,636509,1917,114,107,0,16/01/2021
293240,521537,228169,6538,West Bengal,16238,505299,528075,1445594,521537,15509,1045,128,16/02/2021
977083,2390413,1413039,410203,West Bengal,223128,2167285,2800616,3234165,2390413,113948,4731,291,16/03/2021
3479382,7499090,4018864,1109692,West Bengal,930115,7678667,8608782,7499090,7499090,615570,3320,844,16/04/2021
1089,2085,996,0,West Bengal,0,2085,2085,638092,2085,366,191,0,17/01/2021
300141,538752,238483,12285,West Bengal,19050,519702,551037,1566265,538752,15946,1048,128,17/02/2021
1032857,2509023,1475864,424871,West Bengal,230470,2278553,2933894,3349195,2509023,117470,4824,302,17/03/2021
3515521,7577053,4060679,1162663,West Bengal,953764,7785952,8739716,7577053,7577053,366910,1943,853,17/04/2021
2807,5060,2253,0,West Bengal,0,5060,5060,675858,5060,730,241,0,18/01/2021
293031,544667,251544,18623,West Bengal,23610,521057,563290,1710845,544667,16542,1050,92,18/02/2021
1082012,2620345,1538024,441677,West Bengal,237404,2382941,3062022,3458132,2620345,123609,4945,309,18/03/2021
3522428,7593056,4069772,1171094,West Bengal,960216,7803934,8764150,7593056,7593056,489171,2889,856,18/04/2021
7541,12364,4823,0,West Bengal,0,12364,12364,693899,12364,916,252,0,19/01/2021
318098,596408,278191,35680,West Bengal,28205,568203,632088,1830859,596408,17274,1089,119,19/02/2021
1205835,2877629,1671457,463298,West Bengal,249334,2628295,3340927,3732855,2877629,128872,4991,337,19/03/2021
3572137,7701111,4128110,1275030,West Bengal,986681,7989460,8976141,7701111,7701111,604585,3414,864,19/04/2021
9127,14624,5497,0,West Bengal,0,14624,14624,703670,14624,1405,360,0,20/01/2021
323474,620329,296740,44526,West Bengal,33376,586953,664855,1933555,620329,18026,1120,115,20/02/2021
1285001,3041746,1756385,481405,West Bengal,264887,2776859,3523151,3880847,3041746,133788,5082,360,20/03/2021
3631015,7830594,4198697,1379100,West Bengal,1007847,8201847,9209694,7830594,7830594,490740,2747,882,20/04/2021
12661,20206,7545,0,West Bengal,0,20206,20206,717475,20206,1661,421,0,21/01/2021
324089,625050,300846,44711,West Bengal,35367,589683,669761,1959984,625050,19706,1157,115,21/02/2021
1298588,3069585,1770633,484052,West Bengal,269007,2800578,3553637,3902059,3069585,138756,5118,364,21/03/2021
3678829,7934464,4254741,1461604,West Bengal,1026194,8369874,9396068,7934464,7934464,459350,2437,894,21/04/2021
27526,41970,14409,0,West Bengal,0,41970,41970,752143,41970,1820,461,35,22/01/2021
332532,662851,330217,64029,West Bengal,44461,618390,726880,1990972,662851,20998,1239,102,22/02/2021
1392159,3265575,1873025,508211,West Bengal,289195,2976380,3773786,4124094,3265575,143466,5176,391,22/03/2021
3720337,8024582,4303341,1533651,West Bengal,1041310,8516923,9558233,8024582,8024582,644920,3770,904,22/04/2021
28377,43180,14762,0,West Bengal,0,43180,43180,769223,43180,2122,559,41,23/01/2021
342221,712116,369791,76160,West Bengal,57820,654296,788276,2006899,712116,22579,1367,104,23/02/2021
1490749,3470008,1978855,539302,West Bengal,316448,3153560,4009310,4301140,3470008,145669,5198,404,23/03/2021
3773140,8139244,4365184,1641011,West Bengal,1060048,8720207,9780255,8139244,8139244,622920,3552,920,23/04/2021
30318,46143,15780,0,West Bengal,0,46143,46143,779427,46143,2348,588,45,24/01/2021
356527,778861,422228,94156,West Bengal,72499,706362,873017,2023019,778861,24214,1428,106,24/02/2021
1543690,3582371,2038274,558903,West Bengal,332044,3250327,4141274,4410242,3582371,148268,5248,407,24/03/2021
3813048,8227116,4413135,1711307,West Bengal,1075009,8863414,9938423,8227116,8227116,336400,1827,933,24/04/2021
59165,87815,28568,0,West Bengal,0,87815,87815,826098,87815,2713,632,82,25/01/2021
374446,864083,489528,114768,West Bengal,90503,773580,978851,2028361,864083,24879,1447,109,25/02/2021
1594631,3694698,2099651,579602,West Bengal,343454,3351244,4274300,4520806,3694698,153289,5383,416,25/03/2021
3820268,8243729,4422524,1725523,West Bengal,1078588,8890664,9969252,8243729,8243729,210925,1187,937,25/04/2021
59755,88627,28788,0,West Bengal,0,88627,88627,846669,88627,2946,663,84,26/01/2021
391908,953882,561866,138847,West Bengal,109727,844155,1092729,2003957,953882,25387,1464,108,26/02/2021
1728317,3964483,2235732,601076,West Bengal,359597,3604886,4565559,4798152,3964483,157282,5480,434,26/03/2021
3874965,8363314,4487398,1865680,West Bengal,1096741,9132253,10228994,8363314,8363314,618981,3567,951,26/04/2021
89485,130937,41351,0,West Bengal,0,130937,130937,873591,130937,3487,691,101,27/01/2021
1817585,4142861,2324822,612497,West Bengal,369359,3773502,4755358,4969336,4142861,159810,5518,454,27/03/2021
3921834,8467133,4544342,1970532,West Bengal,1119849,9317816,10437665,8467133,8467133,534313,2966,957,27/04/2021
110239,161415,51073,0,West Bengal,0,161415,161415,901708,161415,3882,706,103,28/01/2021
1820072,4147868,2327342,612683,West Bengal,369445,3778423,4760551,4973231,4147868,161277,5531,454,28/03/2021
130779,191566,60682,0,West Bengal,0,191566,191566,931489,191566,4261,722,105,29/01/2021
1829945,4168357,2337954,614089,West Bengal,372341,3796016,4782446,4994071,4168357,163214,5568,458,29/03/2021
145512,214018,68401,0,West Bengal,0,214018,214018,955072,214018,4714,744,105,30/01/2021
1918974,4349213,2429762,629394,West Bengal,381807,3967406,4978607,5175993,4349213,167641,5684,477,30/03/2021
145649,214256,68502,0,West Bengal,0,214256,214256,958296,214256,4913,750,105,31/01/2021
1979678,4469266,2489095,645383,West Bengal,389481,4079785,5114649,5296180,4469266,171119,5721,493,31/03/2021
